Han sa att han inte ville träffa sin svärmor.	He said that he did not want to meet his mother-in-law.
Är du bra på att måla?	Are you good at painting?
Ja, jag ska finnas där för dem.	Yes, I will be there for them.
Prästen hade kommit.	The priest had come.
Hon hade hört mig.	She had heard me.
Tjejerna hade inte ätit än.	The girls had not eaten yet.
Hon hade aldrig hittat honom.	She had never found him.
Motorn hade dött.	The engine had died.
Jag hade förlorat.	I had lost.
Hade du stängt dörren?	Had you closed the door?
Jag hade känt mig ensam.	I had felt lonely.
Vem hade tagit pengarna?	Who had taken the money?
Hon hade skrivit ett brev.	She had written a letter.
Jag hade i alla fall försökt.	I had at least tried.
Hade han öppnat garderoben?	Had he opened the closet?
Det hade funnits älgar i byn.	There had been moose in the village.
Han hade upptäckt en stor skog.	He had discovered a big forest.
Soldaterna hade upptäckt fienderna.	The soldiers had discovered the enemies.
Ser du vad jag ser?	Do you see what I see?
Soppan var kall, vilket gjorde mig arg.	The soup was cold, which made me angry.
I staden där vi bor finns det många hus.	In the city where we live there are many houses.
Mannen som sitter där är min pappa.	The man who is sitting there is my dad.
Där står huset i vilket mannen bodde när han var liten.	There is the house in which the man lived when he was young.
Han hade hittat en bok på biblioteket.	He had found a book at the library.
Turisten hade ätit någonting dåligt.	The tourist had eaten something bad.
Hur mycket kostar mjölk i landet där	du bor?	How much does milk cost in the country where you live?
Vi hade inte känt varandra så länge.	We had not known each other that long.
Det hade funnits kaniner i huset.	There had been rabbits in the house.
Problemen kommer att öka.	The problems are going to increase.
Det är bra att stå ibland.	It is good to stand sometimes.
Jag vill ha en man att räkna med.	I want a man to count on.
Jag måste bygga en större garderob till min fru.	I have to build a bigger closet for my wife.
Myggan kommer att dö.	The mosquito is going to die.
Du måste acceptera det.	You must accept it.
Hon vill inte acceptera min åsikt.	She does not want to accept my opinion.
Du måste undvika honom!	You have to avoid him!
Jag kan inte tvinga dig.	I cannot force you.
De försökte tvinga oss att betala.	They tried to force us to pay.
Hon brukade bära hans väska.	She used to carry his bag.
Vi behöver tillverka mer mat.	We need to produce more food.
Han verkade uppskatta förslaget.	He seemed to appreciate the suggestion.
Jag brukar uppskatta hennes	förslag.	I usually appreciate her suggestions.
Jag vill möta kungen!	I want to meet the king!
Jag vill möta nya människor.	I want to meet new people.
Vi kunde inte slå dem.	We could not beat them.
Det är omöjligt att slå henne!	It is impossible to beat her!
Vad kan såsen innehålla?	What can the sauce contain?
Vad måste boken innehålla?	What does the book have to contain?
Var får jag ställa cykeln?	Where may I put the bicycle?
Det är svårt att definiera.	It is difficult to define.
Kan du definiera det här ordet?	Can you define this word?
Du borde kunna baka en tårta.	You should be able to bake a cake.
Du måste respektera dina föräldrar.	You have to respect your parents.
Kan du bära min väska åt mig?	Can you carry my bag for me?
Vi kommer inte att kunna slå dem i dag.	We are not going to be able to beat them today.
Katten vill försvinna.	The cat wants to disappear.
Hur kunde den bara försvinna?	How could it just disappear?
Han vill avsluta boken.	He wants to finish the book.
Vi måste avsluta samtalet.	We must finish the conversation.
Jag vill torka dina tårar.	I want to dry your tears.
De kunde bara försvinna.	They could just disappear.
Hon har inget att förlora.	She has nothing to lose.
Jag vill inte förlora honom.	I do not want to lose him.
Det är inget att diskutera.	It is nothing to discuss.
Kan du fylla skålen med vatten?	Can you fill the bowl with water?
Han måste fylla flaskan med mjölk.	He has to fill the bottle with milk.
Du kan inte blanda te och kaffe.	You cannot mix tea and coffee.
Vill du byta?	Do you want to switch?
Vi ska byta tåg i Malmö.	We will change trains in Malmö.
Hunden vill kyssa dig.	The dog wants to kiss you.
Kan han lida av det?	Can he suffer from that?
Hon försökte varna dig!	She tried to warn you!
Vi måste flytta skåpet.	We have to move the cabinet.
Vill du presentera dig?	Do you want to introduce yourself?
Kan vi importera en bil från Tyskland?	Can we import a car from Germany?
Sverige måste importera mer olja från Norge.	Sweden has to import more oil from	Norway.
Varför måste vi alltid förutsätta att hon har fel?	Why do we always have to assume that she is wrong?
Måste vi förutsätta att chefen alltid vet allt?	Do we have to assume that the boss always knows everything?
Vill du bada?	Do you want to swim?
Jag vill bada.	I want to swim.
Vi ska förbereda oss.	We will prepare.
Jag måste förbereda mig för vintern.	I have to prepare for the winter.
Jag kan hämta senapen.	I can get the mustard.
Sluta analysera allting!	Stop analyzing everything!
Du behöver inte förklara.	You do not need to explain.
Jag kan förklara allting.	I can explain everything.
Jag vill inte hata henne.	I don't want to hate her.
Kan du förklara varför du ligger under sängen?	Can you explain why you are lying under	the bed?
Jag hinner inte förbereda mig.	I do not have time to prepare.
Du måste låta kläderna torka.	You have to let the clothes dry.
Var ska jag egentligen lägga handduken?	Where should I actually put the towel?
Vi vill importera hundra kuddar från Brasilien.	We want to import a hundred pillows from Brazil.
Jag vill flytta till Kina.	I want to move to China.
Att ställa alla flaskor på samma ställe är ingen bra idé.	Putting all the bottles in the same place is not a good idea.
Jag orkar inte bära de här böckerna.	I cannot carry these books.
Jag måste varna dig för henne.	I must warn you about her.
Räcker det att blanda mjölk och	smör?	Is it enough to mix milk and butter?
De älskar tröjorna.	They love the sweaters.
Har du inget te?	Don't you have tea?
Biet är gult och svart.	The bee is yellow and black.
Jag går.	I am walking.
Det är ett bi bakom dig!	There is a bee behind you!
Jag hatar att se dem lida.	I hate to see them suffer.
Jag kommer aldrig att kunna förlåta	honom.	I will never be able to forgive him.
Kocken hade hittat en myra i soppan.	The cook had found an ant in the soup.
Professorn hade glömt att svara på frågan.	The professor had forgotten to answer the question.
Det hade funnits fisk i sjön.	There had been fish in the lake.
På gatan där jag bor finns det många katter.	On the street where I live there are many cats.
Det är omöjligt att hata honom.	It is impossible to hate him.
De älskar att diskutera.	They love to discuss.
Jag måste avsluta mitt arbete.	I have to finish my work.
Han hade upptäckt en handduk i kylskåpet.	He had discovered a towel in the refrigerator.
Du måste respektera hans beslut att bli präst.	You have to respect his decision to become a priest.
Ge mig frid!	Give me peace!
Hon lär hunden hämta tidningen.	She is teaching the dog to get the newspaper.
Du behöver inte stötta mig i det här valet.	You do not need to support me in this decision.
Jag försökte alltid undvika dem.	I always tried to avoid them.
Öppna gränserna!	Open the borders!
Jag behöver diskutera det med mina föräldrar.	I need to discuss it with my parents.
Jag tycker inte om att förutsätta saker om människor.	I do not like to assume things about people.
Han försöker undvika henne.	He tries to avoid her.
Det är en liten värld.	It is a small world.
En blå himmel	A blue sky
Min syster ser månen.	My sister sees the moon.
Vilken våg!	What a wave!
Mer än hälften av världens befolkning bor i städer.	More than half of the world's population lives in cities.
Det är en vacker äng.	It is a beautiful meadow.
Världen är stor.	The world is big.
Hon vill bada i ett hav av sås.	She wants to swim in a sea of sauce.
Köttet smakar som trä.	The meat tastes like wood.
Är solen gul?	Is the sun yellow?
Trädet är stort.	The tree is big.
Gräset är grönt.	The grass is green.
Var ser du månen?	Where do you see the moon?
Flickan köper en blå blomma.	The girl is buying a blue flower.
Det måste finnas salt i havet.	There has to be salt in the sea.
Jag ser blommorna.	I see the flowers.
Lila regn	Purple rain
Ge mig mer is!	Give me more ice!
Stjärnorna på himlen	The stars in the sky
Det finns ingen luft på månen.	There is no air on the moon.
Min eld är den största i Sverige.	My fire is the biggest in Sweden.
Jag ska följa dig genom eld och	vatten.	I will follow you through fire and water.
Luften är fri.	The air is free.
En stjärna föll.	A star fell.
Vädret	The weather
Berget	The mountain
De är på fjället.	They are on the mountain.
Landet har många floder.	The country has many rivers.
Jag älskar att vara i naturen!	I love to be in nature!
Tycker du om att vara i naturen?	Do you like to be in nature?
Det finns många vulkaner på Island.	There are many volcanoes in Iceland.
Vi vill ha en bättre miljö för våra	barn.	We want a better environment for our children.
Jag kan inte studera i den här miljön.	I cannot study in this environment.
Min bror simmar i floden.	My brother is swimming in the river.
Vad är en vulkan?	What is a volcano?
En sten	A stone
Granen är grön.	The spruce is green.
Trädet har barr.	The tree has needles.
Bordet är av trä.	The table is wooden.
Planeten är grön och blå.	The planet is green and blue.
Stenen är grå.	The stone is gray.
Granar har barr.	Spruces have needles.
Har trädet barr?	Does the tree have needles?
Det hänger en lång svart orm i trädet.	There is a long black snake hanging in the tree.
Jag ser inga berg!	I do not see any mountains!
Författaren försökte tvinga mig att köpa den nya boken.	The writer tried to force me to buy the new book.
Jag måste hämta plånboken.	I have to get my wallet.
Havets vågor	The waves of the sea
Jag sjunger i regnet.	I am singing in the rain.
Pojken, vars mamma är lärare, vet mycket om naturen.	The boy, whose mom is a teacher, knows a lot about nature.
Han tänker alltid på miljön.	He is always thinking of the environment.
Jag vill ha en stol av trä.	I want a wooden chair.
Vädret var perfekt i går.	The weather was perfect yesterday.
Vi dansar i regnet.	We are dancing in the rain.
Jag älskar regn!	I love rain!
Alla pratar om vädret.	Everybody is talking about the weather.
De ligger på ängen.	They are lying in the meadow.
Vi sitter runt elden och sjunger.	We are sitting around the fire and singing.
Vår planet har en måne.	Our planet has a moon.
Ingen kommer att stoppa oss.	Nobody is going to stop us.
Eleverna hade gått till skolan.	The students had gone to school.
Vill du ha is i vattnet?	Do you want ice in the water?
Duken måste täcka bordet.	The tablecloth must cover the table.
Katten förbereder sig för att hoppa från stolen.	The cat is preparing to jump from the chair.
Min flickvän hade gett sin syster en gyllene väska.	My girlfriend had given her sister a golden bag.
Björnen hade försökt äta upp alla bären.	The bear had tried to eat all the berries.
Det finns inget dåligt väder, bara dåliga kläder.	There is no bad weather, just bad clothes.
Jag går på gräset.	I am walking on the grass.
Ingen verkade uppskatta	presentationen.	Nobody seemed to appreciate the	presentation.
Det finns mycket berg i Österrike.	There are a lot of mountains in Austria.
Får jag låna din telefon?	May I borrow your phone?
Ett träd	Atree
Vi åker till fjällen.	We are going to the mountains.
Var är träden?	Where are the trees?
Kommer du att kunna träffa honom?	Are you going to be able to meet him?
Vi måste respektera varandra.	We have to respect each other.
Jag vill inte att du ska lida.	I do not want you to suffer.
Vi försökte analysera problemet.	We tried to analyze the problem.
Du kommer att älska staden!	You are going to love the city!
Du kan lägga boken på skrivbordet.	You can put the book on the desk.
Läraren hade tagit min mobil.	The teacher had taken my cell phone.
Kvinnan som öppnade dörren är min	mamma.	The woman who opened the door is my mom.
Det finns många blommor på ängen.	There are many flowers in the meadow.
I morgon bitti ska det snöa mycket.	Tomorrow morning it is going to snow a lot.
Det snöar.	It is snowing.
Titta, det snöar!	Look, it is showing!
Det snöade hela dagen i går.	It snowed all day yesterday.
Det har börjat snöa igen.	It has started to snow again.
Jag tycker om klimatet här.	I like the climate here.
En å och en ö	A river and an island
Röken var grå.	The smoke was gray.
Jorden är djup.	The soil is deep.
Jorden är svart.	The soil is black.
Ingenting kan växa här.	Nothing can grow here.
Granen växer i dalen.	The spruce grows in the valley.
Det finns många åar i Sverige.	There are many rivers in Sweden.
Min blomma växer långsamt.	My flower grows slowly.
Det finns träd med löv och träd med barr.	There are trees with leaves and trees with needles.
Universums gränser	The universe's borders
Det där molnet ser ut som en kanin.	That cloud looks like a rabbit.
Det är ett väldigt konstigt landskap.	It is a very strange landscape.
Vinden blåser.	The wind is blowing.
Jag ger dig rosen.	I am giving you the rose.
Molnen blåser i vinden.	The clouds are blowing in the wind.
Universum är stort.	The universe is big.
Jag köper röda rosor.	I am buying red roses.
Landskapet är mycket vackert.	The landscape is very beautiful.
A gas
Jag älskar snö!	I love snow!
Materialet är grått.	The material is gray.
Hon har bara en växt.	She has only one plant.
Barnen leker i sanden.	The children are playing in the sand.
Du ser dammet på stolen.	You see the dust on the chair.
Det finns sand på stranden.	There is sand at the beach.
Växterna är gröna.	The plants are green.
Min brors hus är fullt av damm.	My brother's house is full of dust.
Vilket av materialen är bäst?	Which of the materials is best?
En blixt	A bolt of lightning
Åska och regn	Thunder and rain
Min bror är rädd för åska.	My brother is afraid of thunder.
Metallen är kall.	The metal is cold.
Jag vill leva i rymden.	I want to live in outer space.
Vi tittade på norrskenet.	We looked at the northern lights.
Har ni ofta norrsken här?	Do you often have northern lights here?
Såg du blixten?	Did you see the lightning?
Ett vattenfall	A waterfall
Frost är vackert.	Frost is beautiful.
De sitter och äter.	They are sitting and eating.
Jag sitter och läser.	I am sitting and reading.
De ligger och sover.	They are lying down and sleeping.
Barnet ligger och pratar.	The child is lying down and talking.
Hon står och gråter.	She is standing and crying.
Han står och tittar på dig.	He is standing and looking at you.
Skjortan är i regnbågens alla färger.	The shirt is in all the colors of the rainbow.
Barnen håller på och lär sig engelska.	The children are learning English.
Han håller på att bygga en stad av leksaker.	He is building a city of toys.
Ser du regnbågen?	Do you see the rainbow?
Du är en stjärna.	You are a star.
På vägen dit såg vi norrsken.	On the way there we saw northern lights.
Det kom rök från huset.	There was smoke coming from the house.
Vad håller du på med egentligen?	What are you actually doing?
Jag har på mig en tröja med en blixt på.	I am wearing a sweater with a lightning	bolt on it.
Vi måste tillverka fler bilar.	We must produce more cars.
Det är ett bra material.	It is a good material.
Här är din ros.	Here is your rose.
Löven blir gula och röda.	The leaves are becoming yellow and red.
Det är en dålig idé att försöka kyssa en älg.	It is a bad idea to try to kiss a moose.
Det finns potatis i jorden.	There are potatoes in the soil.
