Nittonhundratalet	The twentieth century---
Jag vill ha hälften.	I want half.---
Vi arbetar fyrtio timmar per vecka.	We work forty hours per week.---
Har du den sjunde stolen?	Do you have the seventh chair?---
De pratar om sina resor till Sverige.	They are talking about their trips to	Sweden.---
Var är biljetterna?	Where are the tickets?---
Han ger mig europeiska skor.	He is giving me European shoes.---
Jag letar efter min ryggsäck.	I am looking for my backpack.---
Är han vuxen?	Is he an adult?---
Mina föräldrar åker utomlands.	My parents are going abroad.---
Tredje generationen	The third generation---
Han är det tredje offret.	He is the third victim.---
Vi vilar i en annan allé.	We are resting in another alley.---
Hon lämnar honom.	She is leaving him.---
De importerar vin.	They import wine.---
Boken tillhör mig.	The book belongs to me.---
Vem berättar för henne?	Who is telling her?---
Jag berättar allt för dig!	I tell you everything!---
Hyllan hänger på väggen.	The shelf is hanging on the wall.---
Jag tillbringar sommaren hemma.	I am spending the summer at home.---
Min bror undervisar i kinesiska.	My brother teaches Chinese.---
Varför undervisar du inte i svenska?	Why don't you teach Swedish?---
Fungerar det?	Does it work?---
Hur fungerar det?	How does it work?---
Passar skorna?	Do the shoes fit?---
Vi delar huset.	We are sharing the house.---
Jag hatar måndagar.	I hate Mondays.---
Hon förklarar varför.	She is explaining why.---
Sekreteraren förklarar hur datorn	fungerar.	The secretary is explaining how the	computer works.---
Hon skickar många brev.	She sends many letters.---
Hon antar att vi har fel.	She assumes that we are wrong.---
Hans telefonnummer är långt.	His telephone number is long.---
Hon bor på åttonde våningen.	She lives on the eighth floor.---
Stora mängder mat	Large amounts of food---
Vi tar på oss varma kläder.	We are putting on warm clothes.---
Han lägger duken på bordet.	He is laying the tablecloth on the table.---
Jag delar med mig av mina pengar.	I am sharing my money.---
Jag skriver inte under det där!	I am not signing that!---
De ber om bröd.	They are asking for bread.---
Museet stänger nu.	The museum is closing now.---
Restaurangen stänger klockan elva.	The restaurant is closing at eleven.---
Det angår mig inte.	It does not concern me.---
Denna fråga angår oss alla.	This question concerns us all.---
Hon förlorar aldrig.	She never loses.---
Han besöker sin bror.	Heiis visiting his brother.---
Hon ber om hans telefonnummer.	She is asking for his phone number.---
Han skär brödet.	He is cutting the bread.---
Håller du med?	Do you agree?---
Vem äter upp all mat?	Who is eating up all of the food?---
Hon skriver under brevet.	She is signing the letter.---
Vi kommer fram klockan nio.	We are arriving at nine o'clock.---
Han dyker upp på skärmen.	He appears on the screen.---
Vi ses!	See you!---
Minns du?	Do you remember?---
Vad fattas?	What is missing?---
Alla lyckas.	Everybody succeeds.---
Om du inte försöker lyckas du aldrig.	If you do not try you never succeed.---
Trivs du här?	Do you like it here?---
Jag misslyckas.	I am failing.---
Vi träffas ofta.	We meet often.---
Vi hoppas att han kommer.	We hope that he is coming.---
Jag hoppas att han ger mig ett svar.	I hope that he gives me an answer.---
Jag skyndar mig.	I am hurrying.---
Vi lär oss svenska.	We are learning Swedish.---
Vi gifter oss i dag.	We are getting married today.---
De säger att de gifter sig i morgon.	They say that they are getting married	tomorrow.---
Jag känner mig trött.	I feel tired.---
Han känner sig gammal.	He feels old.---
Det överraskar mig inte.	It does not surprise me.---
Ibland överraskar jag mig själv.	Sometimes I surprise myself.---
Vi förbereder oss för resan.	We are preparing for the trip.---
Jag förbereder mig för helgen.	I am preparing for the weekend.---
Vem bryr sig om oss?	Who cares about us?---
Du bryr dig inte om någon!	You do not care about anybody!---
Jag tar på mig skorna.	I am putting on my shoes.---
Jag delar med mig av det jag har.	I share what I have.---
Varför träffas vi alltid här?	Why do we always meet here?---
Pojken blir trött.	The boy is getting tired.---
Han har med sig öl.	He has beer with him.---
Hon liknar sin mor.	She looks like her mother.---
Han tillbringar mycket tid med	barnen.	He spends a lot of time with his children.---
Mängden vatten är ungefär samma.	The amount of water is approximately the	same.---
Han kommer klockan tolv.	He is coming at twelve o'clock.---
Nu är klockan halv fem.	Now, it is half past four.---
Modellen har nittio par svarta skor.	The model has ninety pairs of black shoes.---
Männen har i genomsnitt två par	skor.	The men have on average two pairs of	shoes.---
Huset är värt mycket pengar.	The house is worth a lot of money.---
Leksakerna är värda hundratals	kronor.	The toys are worth hundreds of crowns.---
Tjugofem är hälften av femtio.	Twenty-five is half of fifty.---
Min mamma är dubbelt så gammal	som jag.	My mom is twice as old as me.---
Jag arbetar sammanlagt tre veckor.	I work a total of three weeks.---
Den åttonde december	The eighth of December---
Sex veckor till	Six more weeks---
Den är i det andra skåpet.	It is in the other cabinet.---
Man behöver alltid vatten.	One always needs water.---
De här böckerna är mina.	These books are mine.---
Vad är det där?	What is that?---
Behöver du någonting?	Do you need anything?---
Han tappar nycklarna.	He loses his keys.---
Jag läser en anteckning.	I am reading a note.---
Jag vill ha dina anteckningar.	I want your notes.---
Hans uppsats är bra.	His essay is good.---
Vilken bra ansökning!	What a good application!---
Det är ett svårt prov.	It is a difficult exam.---
Har du kunskaper i engelska?	Do you have knowledge of English?---
Vi behöver en person med	kunskaper i finska.	We need a person with knowledge of	Finnish.---
Nu läser jag det sista kapitlet.	Now I am reading the last chapter.---
Han sjunger inte, trots att han vill.	He is not singing, even though he wants to.---
Övningen är för lång.	The exercise is too long.---
Han gör sina läxor.	He is doing his homework.---
Har ni många svårigheter?	Do you have many difficulties?---
Jag vill ha en förklaring.	I want an explanation.---
Hans presentation av Sveriges	universitet är mycket bra.	His presentation of Sweden's universities	is very good.---
Jag har ett mål.	I have a goal.---
Vad betyder det här ordet?	What does this word mean?---
De har också undervisning på	engelska.	They also have instruction in English.---
Läraren ger oss flera bra exempel	från hans romaner.	The teacher is giving us several good	examples from his novels.---
Varför gifter ni er inte?	Why don't you get married?---
Hon trivs med sitt arbete.	She enjoys her work.---
Vi tar av oss skorna.	We are taking off our shoes.---
Pappas katt ser sig själv i spegeln.	Dad's cat sees itself in the mirror.---
En viktig studie	An important study---
Barnen leker på rasten.	The children play during the break.---
Min mamma har många idéer.	My mother has many ideas.---
Vi har anteckningar från	föreläsningen.	We have notes from the lecture.---
Mina läxor är svåra.	My homework is difficult.---
Har du några andra vänner?	Do you have any other friends?---
Allt känns bra igen.	Everything feels good again.---
Vi lägger till två nya böcker.	We are adding two new books.---
Han tar med sig barnen.	He is bringing the children.---
Vi ses där.	See you there.---
Pojken räknar till sju.	The boy is counting to seven.---
Det angår bara honom och hans	familj.	It only concerns him and his family.---
Vi anser att du simmar för ofta.	We think that you swim too often.---
Hur känns det?	How does it feel?---
Mormor saknar sina barnbarn.	Grandmother misses her grandchildren.---
Något fattas.	Something is missing.---
Han sover halva tiden.	He sleeps half the time.---
Han försöker men misslyckas ändå.	He tries but fails anyway.---
Nu lämnar vi landet!	Now we are leaving the country!---
Han lämnar alltid fönstret öppet när	han sover.	He always leaves the window open when	he sleeps.---
Vad betyder det här?	What does this mean?---
Jag äter mindre bröd nu.	Il eat less bread now.---
Tar du med dig vin till festen?	Are you bringing wine to the party?---
Skådespelaren blir berömd.	The actor is getting famous.---
Vi skyndar oss hem.	We are hurrying home.---
Gästerna dyker upp på	eftermiddagen.	The guests appear in the afternoon.---
Jag mår bra.	Il am doing well.---
Min bror missar alltid tåget.	My brother always misses the train.---
Jag håller med.	Il agree.---
Jag lägger till nya vänner.	I am adding new friends.---
Hörde du vad jag sade?	Did you hear what I said?---
Han lämnade sällan soffan.	He rarely left the sofa.---
Jag ringde dig i går.	I called you yesterday.---
Jag åt lunch med min advokat i går.	I ate lunch with my lawyer yesterday.---
Hon lämnade honom för en annan	man.	She left him for another man.---
Du betyder mycket för mig.	You mean a lot to me.---
Föreläsningarna är intressanta.	The lectures are interesting.---
Vad anser du om henne?	What do you think of her?---
De kommer fram till Amerika.	They are arriving in America.---
Han pratade tydligt.	He spoke clearly.---
Vi drack bara kaffe.	We only drank coffee.---
Såg du mig?	Did you see me?---
Simmade hon i går?	Did she swim yesterday?---
Regnade det i går?	Did it rain yesterday?---
Han älskade henne.	He loved her.---
Jag tappade mobilen.	I lost my cell phone.---
Han ville ha en ny tv.	He wanted a new TV.---
Det var allt jag ville ha.	It was all I wanted.---
De tyckte om varandra.	They liked each other.---
Läraren förklarar vad det betyder.	The teacher explains what it means.---
Jag är värd det.	I am worth it.---
Han var inte hemma.	He was not at home.---
Vi gick på bio.	We went to the cinema.