Det är omöjligt att leva utan luft.	It is impossible to live without air.
Det är frost på fönstret.	There is frost on the window.
Min hund leker med löven.	My dog is playing with the leaves.
Du behöver inte stå här hela dagen.	You do not have to stand here all day.
Det är inte ett moln på himlen i dag.	There is not a cloud in the sky today.
Jag bor nära en å.	I live close to a river.
Det är sand i min sko.	There is sand in my shoe.
Sol, vind och vatten	Sun, wind and water
Jag har aldrig sett ett vackrare	landskap!	I have never seen a more beautiful	landscape!
Rosorna är gula.	The roses are yellow.
Röken var inte svart, utan vit.	The smoke was not black, but white.
Luften i staden är full av olika gaser.	The air in the city is full of different gases.
Ingen rök utan eld	No smoke without fire
Det är damm på bordet.	There is dust on the table.
De svenska skogarna är fulla av	granar.	The Swedish forests are full of spruces.
Hur ser en gran ut?	What does a spruce look like?
Min son sitter och gör läxan.	My son is sitting and doing his homework.
Växten växte.	The plant grew.
Jag hör åskan.	I hear the thunder.
Hunden sover i gräset.	The dog is sleeping in the grass.
Jag bor nära en flod.	I live near a river.
Boken kommer att skada hans	karriär.	The book is going to hurt his career.
En regnbåge!	A rainbow!
Det ligger frost på gräset.	There is frost on the grass.
Jag har försökt förklara men ingen	lyssnar på mig.	I have tried to explain but nobody is	listening to me.
Det finns stjärnor, planeter och	månar i rymden.	There are stars, planets and moons in	outer space.
Det finns ett hotell av is i norra	Sverige.	There is a hotel made of ice in northern	Sweden.
I staden där jag bor finns det många	träd.	In the city where I live, there are many	trees.
Är kläderna torra än?	Are the clothes dry yet?
Glaset är sönder.	The glass is broken.
Isen är hård.	The ice is hard.
Det blir lagom!	That will be just right!
Är du intresserad?	Are you interested?
Vad är du intresserad av?	What are you interested in?
Jag är mycket intresserad av att lära	mig svenska.	I am very interested in learning Swedish.
Fåret är så mjukt.	The sheep is so soft.
Hennes barn är jobbiga.	Her children are tiresome.
Hennes föräldrar är döda.	Her parents are dead.
Han har en ljus kostym på sig.	He is wearing a bright suit.
Nej, han är inte död.	No, he is not dead.
Det är så jobbigt!	It is so tiresome!
Björnen är inte farlig.	The bear is not dangerous.
Vill du ha en hård eller mjuk	tandborste?	Do you want a hard or soft toothbrush?
Är du gift?	Are you married?
En mörk natt	A dark night
Ett högt torn	A high tower
Vägen är rak.	The road is straight.
Var inte blyg!	Do not be shy!
Din son verkar blyg.	Your son seems shy.
Den är sönder.	It is broken.
Jag kände mig dum.	I felt stupid.
Jag är inte lika ung längre men	precis lika dum.	I am not as young anymore, but just as	stupid.
Han är det smartaste barnet.	He is the smartest kid.
Åk rakt framåt!	Go straight ahead!
Ett torrt vitt vin	A dry white wine
Jag mår illa.	I feel bad.
Det är annorlunda.	It is different.
Hon valde en annorlunda väg.	She chose a different way.
Hon är min enda kusin.	She is my only cousin.
Hon är deras enda dotter.	She is their only daughter.
Kan ni vara lite tystare?	Can you be alittle quieter?
Du är en självklar del av gruppen.	You are a natural part of the group.
Vår hund är en självklar del av	familjen.	Our dog is a natural part of the family.
Vi blev blöta i regnet eftersom vi inte	hade något paraply.	We got wet in the rain since we did not	have an umbrella.
Håll dig vaken!	Stay awake!
Vem har flest böcker?	Who has the most books?
Hennes förslag fick flest röster.	Her suggestion got the most votes.
Det var en tidig morgon.	It was an early morning.
Den här boken är väldigt tjock!	This book is very thick!
Mina föräldrar är alltid så upptagna.	My parents are always so busy.
Det var den värsta natten i mitt liv.	It was the worst night of my life.
De flesta av mina kusiner bor i	Finland.	Most of my cousins live in Finland.
Den smala vägen går från huset till	kyrkan.	The narrow road goes from the house to	the church.
Jag har hört att det finns många	smala vägar i Italien.	I have heard that there are many narrow	roads in Italy.
Ju tidigare, desto bättre	The earlier, the better
Ju snabbare, desto bättre	The quicker, the better
Är den här platsen upptagen?	Is this seat taken?
Jag har läst de flesta av hennes	böcker.	I have read most of her books.
Hon har flest leksaker.	She has the most toys.
På sommaren är nätterna ljusa.	In the summer the nights are bright.
Ju längre du väntar, desto kallare	blir maten.	The longer you wait, the colder the food	gets.
Nu blir nätterna mörka igen.	Now the nights are getting dark again.
Nu kan det inte bli värre!	Now it cannot get worse!
Vattnet är lagom varmt.	The water is not too hot and not too cold.
Frankrike är det enda landet jag inte	har varit i.	France is the only country I have not been	in.
Lammen är tysta nu.	The lambs are quiet now.
Vägen är så smal!	The road is so narrow!
Vill du komma tidigare?	Do you want to come earlier?
Den här bilden ser annorlunda ut.	This image looks different.
Rummet är ljust.	The room is bright.
Blomman är stor och vacker.	The flower is big and beautiful.
Det finns ett högt vattenfall där.	There is a high waterfall there.
Kudden är mjuk.	The pillow is soft.
Det är bara en liten å.	It is just a small river.
Vinden blåser från öster.	The wind is blowing from the east.
Ät inte gul snö!	Do not eat yellow snow!
Vi såg ett stort vattenfall.	We saw a big waterfall.
Det är det självklara valet.	That is the natural choice.
Alla våra osthyvlar är sönder.	All our cheese slicers are broken.
Ju fler kockar, desto sämre soppa	The more cooks, the worse the soup
Alla djuren är farliga.	Allthe animals are dangerous.
Det finns inga dumma frågor.	There are no stupid questions.
Du är den smartaste i klassen.	You are the smartest one in the class.
Vem vill ha en blöt hund?	Who wants a wet dog?
Jag behöver ett tjockt täcke för	vintern.	I need a thick blanket for the winter.
Höga berg och djupa dalar	High mountains and deep valleys
Det var illa!	That was bad!
Barnen var väldigt blyga.	The children were very shy.
Elefanten är ett tungt djur.	The elephant is a heavy animal.
Är ägget hårt?	Is the egg hard?
Är gula ödlor farliga?	Are yellow lizards dangerous?
Såg du den höga vågen?	Did you see the high wave?
Annars gör jag det.	Otherwise I will do it.
Annars får du ingen mat.	Otherwise, you will not get any food.
Dessutom har han en ny bil.	In addition, he has a new car.
Jag går gärna på bio med dig.	I would love to go to the movie theater with	you.
Det var inte alls vad kungen sa.	That was not at all what the king said.
Hon är nog världens bästa läkare.	She is probably the best doctor in the	world.
Han är nog världens bästa advokat.	He is probably the best lawyer in the	world.
Kan vi inte stanna hemma i stället?	Can't we stay at home instead?
Kan vi inte äta soppa i stället för	pasta?	Can't we eat soup instead of pasta?
Även om jag är trött så fortsätter jag.	Even if I am tired, I continue.
Kom hit fort!	Come here fast!
Vad gör du helst?	What would you rather do?
Jag känner henne väl.	I know her well.
Hon kommer alltså inte?	So she is not coming?
Att stanna är alltså inte ett	alternativ.	So, remaining is not an alternative.
Han är min allra bästa vän.	He is my best friend of all.
Helt plötsligt började det regna.	All of a sudden it started to rain.
Plötsligt började vargen springa mot	henne!	Suddenly, the wolf started to run toward	her!
Hur många brev har du fått hittills?	How many letters have you received so	far?
Hittills har vi inte haft några	problem.	So far we have not had any problems.
Han är inte lärare. Han är däremot	smart.	He is not a teacher. However, he is smart.
Jag är inte hungrig. Jag är däremot	törstig.	I am not hungry. However, I am thirsty.
Kom genast hit!	Come here immediately!
Vi måste göra något genast!	We have to do something immediately!
Har du läst igenom breven?	Have you read through the letters?
Det är knappast en spindel!	It is hardly a spider!
Jag kan sjunga och springa	samtidigt.	I can sing and run simultaneously.
Vi har drygt tre veckor på oss.	We have slightly more than three weeks.
Brandmannen är drygt två meter	lång.	The firefighter is slightly more than two	meters tall.
Har ni någonsin varit i Göteborg?	Have you ever been to Gothenburg?
Han är den tråkigaste läraren	någonsin!	He is the most boring teacher ever!
Min son ställer ständigt nya frågor.	My son is constantly asking new questions.
Vi arbetar ständigt med att förbättra	vår service.	We are constantly working to improve our	service.
Vi började skratta samtidigt.	We started to laugh at the same time.
Annars ringer jag dina föräldrar.	Otherwise, I will call your parents.
Hon är restaurangens allra bästa	kock.	She is the restaurant's best cook of all.