Skådespelarna ser oss inte.	The actors do not see us.---
Hon kommer på besök.	She is coming for a visit.---
Jag tycker om hennes katt.	I like her cat.---
Vem vet?	Who knows?---
Finns det ingen sked?	Isn't there any spoon?---
Jag står bakom dig.	I am standing behind you.---
Hennes syster är lång.	Her sister is tall.---
Vad håller du på med?	What are you doing?---
Kvinnan vet var boken är.	The woman knows where the book is.---
Nittonhundratalet	The twentieth century---
Han har en tröja.	He has a sweater.---
Jo, det gör jag.	Yes, I do.---
Det är han som läser min bok.	He is the one who is reading my book.---
Varför gör du det?	Why are you doing it?---
Har du de gamla smutsiga	strumporna?	Do you have the old dirty socks?---
Mannen lagar mat.	The man is cooking.---
Jo, det gör jag.	Yes, I do.---
Har du tid?	Do you have time?---
The movie theater---
Jag äter om du dricker.	I eat if you drink.---
Hon är hos mig.	She is at my place.---
Du äter min hunds mat.	You are eating my dog's food.---
Mannen har flera skärp.	The man has several belts.---
Det tar ett årtionde.	It takes a decade.---
Jag åker tunnelbana till jobbet.	I go by subway to work.---
Vad är du rädd för?	What are you afraid of?---
Fjärde veckan i maj	The fourth week in May---
Vilket datum är det i dag?	What date is it today?---
Ett vitt vin	A white wine---
Hon skrattar.	She is laughing.---
Jag har många fastrar.	I have many aunts.---
Summan	The sum---
Den lila klänningen är min.	The purple dress is mine.---
Han dricker ändå aldrig kaffe.	He never drinks coffee anyway.---
Jag går framåt.	I am walking forward.---
Hon läser hans brev.	She is reading his letter.---
Den lila klänningen är min.	The purple dress is mine.---
En period	A period---
Har du ingen katt?	Don't you have a cat?---
Jag älskar inte dig, utan honom.	I do not love you, but him.---
Är lamporna nya?	Are the lamps new?---
Kockar har knivar.	Cooks have knives.---
Jag ligger vid poolen hela dagen.	I lie by the pool the whole day.---
De gula tallrikarna	The yellow plates---
Mannen använder sin tallrik.	The man is using his plate.---
I årtionden	For decades---
Det tar ungefär en timme.	It takes approximately one hour.---
Varför svarar du inte?	Why aren't you answering?---
Jag missar aldrig bussen!	I never miss the bus!---
Hjulen är vita.	The wheels are white.---
De åker.	They are going.---
Vi tittar på kaffet.	We are looking at the coffee.---
Förra veckan eller förrförra veckan?	Last week or the week before last week?---
Vi simmar i sjön.	We are swimming in the lake.---
Är din mamma på jobbet?	Is your mom at work?---
Jag har hundratals böcker!	I have hundreds of books!---
Hon har inga egna barn.	She has no children of her own.---
Här finns det mycket mat.	Here there is a lot of food.---
Har vi tillräckligt med socker?	Do we have enough sugar?---
Vi bor här.	We live here.---
Många århundraden	Many centuries---
De tar båten till Amerika.	They are taking the boat to America.---
Varför svänger du inte?	Why aren't you turning?---
Vi åker om en timme.	We are going in an hour.---
Soldaten vet vilka de är.	The soldier knows who they are.---
De använder sina strumpor.	They are using their socks.---
Vi går på restaurang.	We are going to a restaurant.---
Förstår du?	Do you understand?---
De gråter.	They are crying.---
Jag skriver århundradets bok.	I am writing the book of the century.---
Har du inga frågor?	Don't you have any questions?---
Röda tak	Red roofs---
Vems är den där boken?	Whose is that book?---
Jag tror dig!	I believe you!---
Varför ligger du på marken?	Why are you lying on the ground?---
Vad gör han för närvarande?	What is he doing currently?---
Vi tar nästa plan till Finland.	We are taking the next plane to Finland.---
Väskan har hjul.	The bag has wheels.---
Inte förrän i morgon.	Not until tomorrow.---
Dessa människor behöver mat och	vatten.	These people need food and water.---
De fortsätter.	They are continuing.---
Känner ni varandra?	Do you know each other?---
Kvinnan har på sig en kostym.	The woman is wearing a suit.---
Handduken torkar inte!	The towel is not drying!---
Lakanet är vitt.	The sheet is white.---
Kvinnan har på sig en klänning.	The woman is wearing a dress.---
Ligger hotellet vid flygplatsen?	Is the hotel by the airport?---
Norden	The Nordic countries---
Hon älskar mig inte.	She does not love me.---
Min mamma är polis.	My mom is a police officer.---
Hon talar till och med svenska.	She even speaks Swedish.---
Vi åker framåt.	We are going forward.---
Vi saknar dig.	We miss you.---
Mitt svar är ja.	My answer is yes.---
om ett halvår	in half a year---
Duken ligger på bordet.	The tablecloth is on the table.---
Har hon inga skor på sig?	Isn't she wearing any shoes?---
Ja, det gör vi alltid.	Yes, we always do that.---
Jag läser mina böcker.	I am reading my books.---
Vi ser sällan sådana stränder.	We rarely see beaches like that.---
Hon vill ha kläderna.	She wants the clothes.---
Jag har bara fyra stycken.	I only have four of them.---
Han sjunger inte särskilt bra.	He does not sing very well.---
De är rädda för vargar.	They are afraid of wolves.---
Era katter dricker vatten.	Your cats are drinking water.---
De älskar era barn.	They love your children.---
Har hon inga skor på sig?	Isn't she wearing any shoes?---
När är bröllopet?	When is the wedding?---
Du väljer hunden.	You choose the dog.---
Flickan som äter ett äpple tycker om	hästar.	The girl who is eating an apple likes	horses.---
I morgon är det helg.	Tomorrow it is the weekend.---
Ett glas vatten	A glass of water---
Om tjugofem år är jag femtio år	gammal.	In twenty-five years I will be fifty years old.---
Varför svänger du inte?	Why aren't you turning?---
Soldaten vet vilka de är.	The soldier knows who they are.---
Det tar en vecka.	It takes a week.---
Varför skrattar du åt mig?	Why are you laughing at me?---
Han är egentligen inte min bror.	He is not actually my brother.---
Jag simmar längs stranden.	Il am swimming along the beach.---
Jag litar på dig!	I trust you!---
Djur arbetar inte.	Animals do not work.---
Jag tappar min mobil.	I lose my cell phone.---
Vilka strumpor är hennes?	Which socks are hers?---
Jag älskar kläderna.	I love the clothes.---
Arbetarna litar inte på chefen.	The workers do not trust the boss.---
Han går inte utan springer.	He is not walking but running.---
Vita älgar är ovanliga.	White moose are unusual.---
Vi simmar på somrarna.	We swim in the summer.---
För ögonblicket arbetar jag.	At the moment I am working.---
Finns det ingen mat?	Isn't there any food?---
Vid vilken tid?	At what time?---
De gör det själva.	They are doing it themselves.---
Han går inte utan springer.	He is not walking but running.---
Förra veckan	Last week---
Han ser fortfarande inte gammal ut.	He still does not look old.---
Hennes dotter klipper i papperet.	Her daughter is cutting the paper.---
Staden ligger på en ö.	The city is located on an island.---
Har du inget svar?	Don't you have an answer?---
Pojken är rädd för garderoben.	The boy is afraid of the closet.---
Finns det inget annat snöre?	Is there no other string?---
De gamla leksakerna är vackra.	The old toys are beautiful.---
Vi hinner inte!	We do not have enough time!---
Barnen ritar på marken.	The children are drawing on the ground.---
Hennes föräldrar har en restaurang.	Her parents have a restaurant.---
Jag talar om din generation.	I am talking about your generation.---
Han har bara en handduk på sig.	He is only wearing a towel.---
Nu börjar äventyret!	Now the adventure starts!---
Jag går på vägen med min hund.	I am walking on the road with my dog.---
Vart går du?	Where are you going?---
Barnen äter glass.	The children are eating ice cream.---
Känner du hans förra pojkvän?	Do you know his last boyfriend?---
Hon har en dålig dag.	She is having a bad day.---
De gråter.	They are crying.---
Vad är hennes ålder?	What is her age?---
Femte hjulet	The fifth wheel---
Ett dygn?	A day?---
Jag går till läkaren på torsdagar.	I go to the doctor on Thursdays.---
När jag lagar mat äter hon.	When I cook, she eats.---
Pojken har ett gult äpple.	The boy has a yellow apple.---
Vad får jag för det?	What do I get for it?---
Ingen vet.	Nobody knows.---
En liten hamn	A small port---
Välkommen till mitt land!	Welcome to my country!---
Älgen äter ett äpple till.	The moose is eating one more apple.---
De gula tallrikarna	The yellow plates---
Fönstret är öppet.	The window is open.---
ingendera av dem	neither of them---
Han är präst.	Heiis a priest.---
De lever i arton år.	They live for eighteen years.---
Hon leker.	She is playing.---
Kallt kaffe	Cold coffee---
De pratar om sina resor till Sverige.	They are talking about their trips to	Sweden.---
Ett århundrade	A century---
Björnen hittar mat.	The bear finds food.---
Han är på semester i Finland.	He is on vacation in Finland.---
Skjortan har knappar.	The shirt has buttons.---
Jag åker tunnelbana till jobbet.	I go by subway to work.---
De andra kvinnorna	The other women---
Jag bygger hus.	I build houses.---
Det är kväll.	It is evening.---
Vin är en dryck.	Wine is a beverage.---
Nätterna är våra.	The nights are ours.---
På lördagar tittar jag alltid på tv.	On Saturdays I always watch TV.---
Vilken dag är det?	What day is it?---
Det finns bröd.	There is bread.---
Vi har svaren.	We have the answers.---
Hur mår du?	How are you?---
Min morbror är min mors bror.	My uncle is my mother's brother.---
Du är inte gammal.	You are not old.---
Tallriken är mellan dig och mig.	The plate is between you and me.---
Vargen äter den svarta ankan.	The wolf is eating the black duck.---
Kvinnorna har på sig klänningar.	The women are wearing dresses.---
Vi arbetar fyrtio timmar per vecka.	We work forty hours per week.---
Varför gör du det?	Why are you doing it?---
Systrarna sjunger.	The sisters are singing.---
Hon sitter framför mig.	Sheiis sitting in front of me.---
Jag går på vägen med min hund.	I am walking on the road with my dog.---
Jag har många fastrar.	I have many aunts.---
Årstiderna är vår, sommar, höst och	vinter.	The seasons are spring, summer, fall and	winter.---
Hon kommer när som helst.	She is coming at any time.---
Ett halvår	Half a year---
Vilka smörgåsar är våra?	Which sandwiches are ours?---
Flickorna läser breven.	The girls are reading the letters.---
Ett ögonblick!	One moment!---
Räcker det?	Is it enough?---
Har du det bekvämt?	Are you comfortable?---
Det är en allvarlig fråga.	It is a serious question.---
Mängden olja är viktig.	The amount of oil is important.---
Vi åker framåt.	We are going forward.---
Vid vilken tid?	At what time?---
Skjortan torkar.	The shirt is drying.---
Min syster är brandman.	My sister is a firefighter.---
Vad har du i fickorna?	What do you have in your pockets?---
Vilken karriär!	What a career!---
Flickan visar sin bok.	The girl is showing her book.---
om ett halvår	in half a year---
Vid vilken tid?	At what time?---
Hur är det möjligt?	How is it possible?---
Tycker du om ditt yrke?	Do you like your profession?---
De bygger båten.	They are building the boat.---
Varför svarar du inte?	Why aren't you answering?---
Jag vill ha dubbelt så mycket.	I want twice as much.---
Jag väljer åt dig.	I am choosing for you.---
Riset	The rice---
Det regnar mycket i november.	It rains a lot in November.---
Mannen har flera skärp.	The man has several belts.---
Jag är född på sommaren.	I was born in the summer.---
Vem har flera sekreterare?	Who has several secretaries?---
Ett ögonblick!	One moment!---
Ser du mig?	Do you see me?---
Landet har långa kuster.	The country has long coasts.---
Min familj bor söder om staden.	My family lives south of the city.---
Vi läser en stund.	We are reading for a while.---
Vi arbetar inte på lördagar.	We do not work on Saturdays.---
Har du några barn?	Do you have any children?---
Mitt ägg är blått.	My egg is blue.---
Skorna är mina.	The shoes are mine.---
Vi hyr cyklar.	We are renting bicycles.---
Min svärfar är min frus far och min	far är hennes svärfar.	My father-in-law is my wife's father, and	my father is her father-in-law.---
Ett stort hjul	A big wheel---
Han bor antingen i Sverige eller i	Finland.	He lives either in Sweden or in Finland.---
Hur tvättar ni de andra mattorna?	How do you wash the other carpets?---
Skorna är mina.	The shoes are mine.---
Pratar vi om samma sak?	Are we talking about the same thing?---
Sjunger han på tisdagar?	Does he sing on Tuesdays?---
Vem som helst	Anyone---
Är det inte torsdag i dag?	Isn't it Thursday today?---
Vart simmar ankan?	Where is the duck swimming?---
Vi äter om en stund.	We are eating in a while.---
Vad gör denna kvinna?	What is this woman doing?---
Dörren är inte ens öppen.	The door is not even open.---
Barnen är tvåspråkiga.	The children are bilingual.---
Mitt svar är ja.	My answer is yes.---
Vem svarar på en sådan fråga?	Who answers a question like that?---
Har vi tillräckligt med socker?	Do we have enough sugar?---
Kostymerna är dyra.	The suits are expensive.---
En värdefull bok	A valuable book---
Hon har skor på sig.	She is wearing shoes.---
Jo, det gör jag.	Yes, I do.---
Varför tycker du så mycket om juni?	Why do you like June so much?---
I september sjunger jag mycket.	In September I sing a lot.---
Inte förrän i morgon.	Not until tomorrow.---
Älgen äter ett äpple till.	The moose is eating one more apple.---
Ett barn, flera barn	A child, several children---
Han tycker om hennes hundar.	He likes her dogs.---
Hon är årtiondets kvinna.	She is the woman of the decade.---
Vi går genom restaurangen.	We are walking through the restaurant.---
Hennes klänning är verkligen	vacker.	Her dress is really beautiful.---
Spädbarnet är en dag gammalt.	The baby is a day old.---
Det är antingen en matta eller en	handduk.	It is either a rug or a towel.---
Vårt äpple	Our apple---
Vem svarar?	Who is answering?---
De gamla leksakerna är vackra.	The old toys are beautiful.---
Vargen vet att björnen sover.	The wolf knows that the bear is sleeping.---
De sover.	They are sleeping.---
Pojken frågar flickan.	The boy is asking the girl.---
De kommer om en kvart.	They are coming in fifteen minutes.---
Det finns flera finlandssvenska	städer i Finland.	There are several Finno-Swedish cities in	Finland.---
De rosa byxorna är hennes.	The pink pants are hers.---
Juli är en månad på året.	July is a month of the year.---
Våra barns böcker	Our children's books---
Det är en vanlig fråga.	It is a normal question.---
Andra veckan i maj	The second week in May---
Jag dricker svart kaffe.	I am drinking black coffee.---
På midsommar äter vi mycket mat.	On Midsummer we eat a lot of food.---
Hon skrattar.	She is laughing.---
Han ser fortfarande inte gammal ut.	He still does not look old.---
Har hon inga skor på sig?	Isn't she wearing any shoes?---
Det tar bara en minut.	It only takes a minute.---
De kommer i helgen.	They are coming this weekend.---
Min farfar är advokat.	My grandfather is a lawyer.---
Han lagar mat medan vi sover.	He cooks while we sleep.---
Vad gör du den sjätte juni?	What are you doing the sixth of June?---
Våra pappor är bröder.	Our dads are brothers.---
Har du en knapp?	Do you have a button?---
Ser de oss?	Do they see us?---
Det finns många sjöar i Sverige.	There are many lakes in Sweden.---
Vi läser en stund.	We are reading for a while.---
Barnen läser breven.	The children are reading the letters.---
Skådespelerskan köper ett palats	med många torn.	The actress is buying a palace with many	towers.---
Det är en väldigt dyr maskin.	It is a very expensive machine.---
Slipsen är hans.	The tie is his.---
Nu är det för sent!	Now it is too late!---
Enligt henne är hästen vit.	According to her, the horse is white.---
Han talar inte heller engelska.	He does not speak English either.---
Vad gör din hund?	What is your dog doing?---
Hon har sin fina klänning på sig.	She is wearing her nice dress.---
Jo, det gör jag.	Yes, I do.---
Vem liknar barnet?	Who does the child resemble?---
Det är nionde gången jag är här.	It is the ninth time I am here.---
Ett stort antal människor.	A large number of people.---
Palatset ligger utanför huvudstaden.	The palace is located outside the capital.---
Åker du dit i kväll?	Are you going there tonight?---
En förälder är ett barns mamma	eller pappa.	A parent is a child's mom or dad.---
I sista sekunden	At the last second---
De kommer på torsdag.	They are coming on Thursday.---
Flickan ritar en älg.	The girl is drawing a moose.---
Jag sover i flera timmar.	I am sleeping for several hours.---
Har du inga frågor?	Don't you have any questions?---
Barnet läser en bok.	The child is reading a book.---
Hotellet ligger vid kusten.	The hotel is located by the coast.---
Min faster är min pappas syster.	My aunt is my dad's sister.---
Till och med jag tycker om henne.	Even I like her.---
Han tycker om er.	He likes you.---
Jag är på semester!	I am on vacation!---
Den sjunde boken är den sista.	The seventh book is the last.---
Jag sitter bakom dig.	I am sitting behind you.---
Han har en vit tröja på sig.	He is wearing a white sweater.---
Nätterna är svarta.	The nights are black.---
Maten räcker inte.	There is not enough food.---
Han fortsätter sitt arbete.	He is continuing his work.---
Är hennes föräldrar författare?	Are her parents writers?---
Det är inte nödvändigtvis en dyr	kostym.	It is not necessarily an expensive suit.---
Hon har på sig strumpor.	She is wearing socks.---
Vi åker till Sverige på semester.	We are going to Sweden on vacation.---
Har du inga frågor?	Don't you have any questions?---
Hur många arbetare har ni?	How many workers do you have?---
Det verkar som att kostymen är	orange.	It seems like the suit is orange.---
Älgar är i allmänhet vegetarianer.	Moose are generally vegetarians.---
Det här är kommittén.	This is the committee.---
Stannar du på en kopp te?	Are you staying for a cup of tea?---
Du känner mig!	You know me!---
Brödet innehåller salt.	The bread contains salt.---
En skjorta, flera skjortor	A shirt, several shirts---
Hon fyller poolen med vatten.	She is filling the pool with water.---
Hon arbetar på en annan avdelning.	She works in another department.---
Mängden olja är viktig.	The amount of oil is important.---
Vad är det för fel på dig?	What is wrong with you?---
Jag tackar dig.	I thank you.---
Jag väntar på dig.	I am waiting for you.---
Museet är inte öppet än.	The museum is not open yet.---
Ett och ett halvt år	One and a half years---
Min moster är min mors syster.	My aunt is my mother's sister.---
Hon är chef för avdelningen.	She is the boss of the department.---
Hennes föräldrar har en restaurang.	Her parents have a restaurant.---
Mannen står bredvid kvinnan.	The man is standing next to the woman.---
Hon använder kläderna innan hon	säljer dem.	She uses the clothes before she sells	them.---
I morgon är det helg.	Tomorrow it is the weekend.---
Jag tycker inte om de bruna äpplena.	I do not like the brown apples.---
Vi köper ett annat bord.	We are buying another table.---
Nej, vi är inte dåliga!	No, we are not bad!---
Jag älskar jackan.	I love the jacket.---
Han tar ett föremål från bordet.	He is taking an object from the table.---
De har på sig kostymerna.	They are wearing the suits.---
Hon dör.	She is dying.---
Jag litar egentligen inte på honom.	I do not actually trust him.---
Om ett ögonblick!	In a moment!---
Jag älskar min moster.	I love my aunt.---
Ert barn läser en tidning.	Your child is reading a newspaper.---
Varför ringer hon mig inte?	Why does she not call me?---
Barnens hundar	The children's dogs---
Vad är dagens datum?	What is today's date?---
Han köper något till barnen.	He is buying something for the children.---
Fryser ni inte?	Aren't you freezing?---
Batteriet är för gammalt.	The battery is too old.---
Vad tillverkar de?	What do they produce?---
Hans kostym kommer om en månad.	His suit is coming in a month.---
Hon är nitton och arbetar med sin	mamma.	She is nineteen and works with her mom.---
Vad skrattar du åt?	What are you laughing at?---
Han följer efter mig.	He is following me.---
Det regnar inte mycket i juli.	It does not rain a lot in July.---
Han kysser mig.	He is kissing me.---
Han får ett svar.	He is getting an answer.---
Alla utom kocken äter.	Everyone except the cook is eating.---
I morgon är det helg.	Tomorrow it is the weekend.---
Vem väntar ni på?	Who are you waiting for?---
Nu är klockan halv fem.	Now, it is half past four.---
Har ni en bastu?	Do you have a sauna?---
Varför svänger du inte?	Why aren't you turning?---
Vem svarar på en sådan fråga?	Who answers a question like that?---
Han har skjortor i olika färger.	He has shirts in different colors.---
Ett antal år	A number of years---
Jag hinner inte i dag.	I do not have enough time today.---
Jag vet inte om han vill.	I do not know if he wants to.---
Ett dygn	A day---
Det är han som läser min bok.	He is the one who is reading my book.---
Vid vilken tid?	At what time?---
Kastrullerna står på bordet.	The saucepans are on the table.---
Hon hör mig inte.	She does not hear me.---
Jag kommer på besök.	I am coming for a visit.---
Jag är född på sommaren.	I was born in the summer.---
Toaletterna är där borta.	The toilets are over there.---
Han lyssnar.	Heiis listening.---
Skon är din.	The shoe is yours.---
Mannen lagar mat.	The man is cooking.---
Din pappa ser ut som en turist.	Your dad looks like a tourist.---
Årstiderna är vår, sommar, höst och	vinter.	The seasons are spring, summer, fall and	winter.---
Vilken skjorta är blå?	Which shirt is blue?---
Svaret är nej.	The answer is no.---
Hur många arbetare har ni?	How many workers do you have?---
Den svarta spindeln	The black spider---
Vad önskar du dig?	What are you wishing for?---
Vi äter mycket mat i december.	We eat a lot of food in December.---
Vårt hotell ligger vid stranden.	Our hotel is by the beach.---
Hon äter inte frukt, inte ens äpplen.	She does not eat fruit, not even apples.---
Det är mitt skärp.	It is my belt.---
Vilket datum är det i dag?	What date is it today?---
År och månader	Years and months---
Björnen är ett stort djur.	The bear is a big animal.---
Vad håller du på med?	What are you doing?---
Det regnar och barnen springer.	It is raining and the children are running.---
De blandar vin med vatten.	They are mixing wine with water.---
Han känner henne.	He knows her.---
Vi visar en turist vägen till hotellet.	We are showing a tourist the way to the	hotel.---
Djuren dricker vatten.	The animals are drinking water.---
Männen läser böckerna.	The men are reading the books.---
Kniven är vid glaset.	The knife is by the glass.---
Du vet att jag älskar dig.	You know that I love you.---
Har du det bekvämt?	Are you comfortable?---
Vad letar ni efter?	What are you looking for?---
Var har ni kastruller?	Where do you keep saucepans?---
Min pappa är en stor man.	My father is a big man.---
Hon tvättar sig med tvål och vatten.	She is washing herself with soap and	water.---
Vi bor i dalen.	We live in the valley.---
Varför svarar du inte?	Why aren't you answering?---
Finns det inga toaletter här?	Aren't there any toilets here?---
Jag orkar inte!	I do not have the energy!---
Fem stycken, tack!	Five of them, please!---
Hallå, är det någon där?	Hello, is there someone there?---
Vi visar en turist vägen till hotellet.	We are showing a tourist the way to the	hotel.---
Hans hund äter fisk.	His dog is eating fish.---
Till och med farfar sjunger.	Even grandfather is singing.---
Fem stycken, tack!	Five of them, please!---
Min moster har många döttrar.	My aunt has many daughters.---
Hur många böcker läser hon?	How many books is she reading?---
Vilken vill du ha? Ingendera.	Which do you want? Neither.---
Jag skriver århundradets bok.	I am writing the book of the century.---
Finns det ingen mat?	Isn't there any food?---
Boken är konstig.	The book is strange.---
Jag älskar mitt yrke.	I love my profession.---
Jag åker tunnelbana till jobbet.	I go by subway to work.---
De har öppet på söndagar.	They are open on Sundays.---
Jag äter hos honom.	I am eating at his place.---
Mannen och kvinnan pratar.	The man and the woman are speaking.---
Han har de gula byxorna.	He has the yellow pants.---
Min familj bor söder om staden.	My family lives south of the city.---
Jag är domare.	Il am a judge.---
Jag gråter inte.	I am not crying.---
Jag tycker om dig, men jag älskar	henne.	I like you, but I love her.---
Är det lördag eller söndag i dag?	Is it Saturday or Sunday today?---
Den sjunde boken är den sista.	The seventh book is the last.---
Jag vill också ha ett äpple.	I also want an apple.---
Ett djur, flera djur	An animal, several animals---
Äntligen ser du mig!	Finally you see me!---
Om en dag	In a day---
Ja, det gör vi alltid.	Yes, we always do that.---
Jag vill ha en smörgås.	I want a sandwich.---
De har öppet på söndagar.	They are open on Sundays.---
Mina föräldrar är gamla.	My parents are old.---
Vi visar en turist vägen till hotellet.	We are showing a tourist the way to the	hotel.---
Du har på dig min tröja.	You are wearing my sweater.---
I årtionden	For decades---
Juni är årets sjätte månad.	June is the sixth month of the year.---
Kaffet är inte varmt.	The coffee is not warm.---
De äter på nätterna.	They eat at night.---
Min pappas bror är min farbror.	My dad's brother is my uncle.---
De är rädda för vargar.	They are afraid of wolves.---
Den nionde april	The ninth of April---
Vad innehåller boken?	What does the book contain?---
De reser runt i landet.	They are traveling around the country.---
Det här är min fru.	This is my wife.---
Det här är kommittén.	This is the committee.---
På fredag kommer brevet.	On Friday the letter is coming.---
Antalet soldater är stort.	The number of soldiers is large.---
Det står en korg på bordet.	There is a basket on the table.---
Pojken har en skjorta.	The boy has a shirt.---
Mannen har brevet.	The man has the letter.---
Han skriver att han älskar henne.	He is writing that he loves her.---
Det är den sista dagen.	It is the last day.---
Han är på arbetet.	He is at work.---
Personalen på restaurangen	The staff at the restaurant---
Vem som helst som arbetar med	barn vet vad jag pratar om.	Anyone who works with children knows	what I am talking about.---
Motorn är effektiv.	The engine is efficient.---
Om en dag	In a day---
Brevet är till vänster om tidningen.	The letter is to the left of the newspaper.---
De första gångerna	The first times---
Det tar ett årtionde.	It takes a decade.---
En liten kaffe, tack!	One small coffee, please!---
Över barnen flyger fåglarna.	Over the children, the birds are flying.---
Det är den femte juli nu.	It is the fifth of July now.---
Behöver du någonting?	Do you need anything?---
De betalar tio miljoner för hotellet.	They are paying ten million for the hotel.---
Den sjunde dagen	The seventh day---
Ett rött skåp	A red cabinet---
Barn bor i allmänhet hos sina	föräldrar.	Children generally live with their parents.---
Vi äter innan vi går.	We eat before we walk.---
Vakten	The guard---
Jag arbetar sammanlagt tre veckor.	I work a total of three weeks.---
Han talar inte heller engelska.	He does not speak English either.---
Våra egna handskar	Our own gloves---
Allén är vackert gul på hösten.	The alley is beautifully yellow in the fall.---
Enligt henne är hästen vit.	According to her, the horse is white.---
Min bror kommer sist.	My brother is coming last.---
Det är måndag i dag.	It is Monday today.---
Vi simmar på somrarna.	We swim in the summer.---
Farmor läser tidningen.	Grandmother is reading the newspaper.---
Vattnet i kastrullen är varmt.	The water in the saucepan is warm.---
Hur kommer man till stranden?	How does one get to the beach?---
Jag litar egentligen inte på honom.	I do not actually trust him.---
Ja, det finns kaffe.	Yes, there is coffee.---
Min mormor har många klockor.	My grandmother has a lot of clocks.---
De rosa byxorna är hans.	The pink pants are his.---
Varför svarar du inte?	Why aren't you answering?---
Långt bort	Far away---
Ni är välkomna till oss i oktober.	You are welcome to our place in October.---
Har du inget svar?	Don't you have an answer?---
Finns det inget kaffe?!	Is there no coffee?!---
Varför ligger sakerna på golvet?	Why are the things lying on the floor?---
Mitt ägg är blått.	My egg is blue.---
Mannen skriver datumet på brevet.	The man is writing the date on the letter.---
En arbetare kommer.	A worker is coming.---
Det är ett smutsigt jobb.	It is a dirty job.---
De är på stranden.	They are at the beach.---
Vi känner inte varandra.	We do not know each other.---
Vi behöver mer tyg.	We need more cloth.---
Han bor i en annan stad.	He lives in another city.---
Artistens vakter springer efter	kvinnan.	The artist's guards are running after the	woman.---
Älgen tittar på pojken.	The moose is looking at the boy.---
En av hundarna springer.	One of the dogs is running.---
En skjorta, flera skjortor	A shirt, several shirts---
Jag simmar inte förrän på tisdag.	Il am not swimming until Tuesday.---
Jag skriver brev på morgonen.	I write letters in the morning.---
Stämmer det?	Is that correct?---
Restaurangerna är öppna.	The restaurants are open.---
Jag läser tidningen sent på kvällen.	I read the newspaper late in the evening.---
Enligt honom är skärpet grönt.	According to him, the belt is green.---
Katten äter fisken.	The cat is eating the fish.---
Min morfar har tio barnbarn.	My grandfather has ten grandchildren.---
Du har en ny klänning.	You have a new dress.---
Hon äter frukost på morgonen.	She eats breakfast in the morning.---
Min mamma är dubbelt så gammal	som jag.	My mom is twice as old as me.---
Vad heter din tvilling?	What is your twin's name?---
Kvinnan älskar sina barn.	The woman loves her children.---
Jag möter dig på hotellet.	I am meeting you at the hotel.---
Barnen leker i en kvart.	The children play for fifteen minutes.---
Jag lagar mat.	I am cooking.---
En biljett, tack!	A ticket, please!---
Jag tycker om de gula fåglarna.	I like the yellow birds.---
Tusentals människor läser hennes	böcker.	Thousands of people read her books.---
Det är precis samma färg.	It is exactly the same color.---
Djuren	The animals---
Hon har sina vanliga kläder på sig.	She is wearing her normal clothes.---
Vi bjuder henne på lunch.	We are treating her to lunch.---
Har de inga tallrikar?	Don't they have any plates?---
Vi frågar sammanlagt hundra	personer.	We are asking a total of a hundred people.---
På eftermiddagen	In the afternoon---
Jag undrar varför.	I wonder why.---
Det tar generationer.	It takes generations.---
Kvinnan tycker om skärpet.	The woman likes the belt.---
Varför lär du honom svenska?	Why are you teaching him Swedish?---
Jag vill ha en halsduk.	I want a scarf.---
Jag ställer flaskan i skåpet.	I am putting the bottle in the cabinet.---
Byggnaden är tom.	The building is empty.---
Det kostar för mycket!	It costs too much!---
Torsdag kommer före fredag.	Thursday comes before Friday.---
Han tror mig inte.	He does not believe me.---
Vilken historisk period läser du om?	What historical period are you reading	about?---
Hallå, är det någon där?	Hello, is there someone there?---
Ett långt brev.	A long letter.---
Pojken springer och sjunger.	The boy is running and singing.---
Pengarna ligger på bordet.	The money is on the table.---
De använder en professionell	modell.	They are using a professional model.---
Det är inte nödvändigtvis hans	mamma.	It is not necessarily his mother.---
Hennes föräldrar har en restaurang.	Her parents have a restaurant.---
Kvinnan har tidningen.	The woman has the newspaper.---
Barnen har många leksaker.	The children have many toys.---
De säljer många olika garderober.	They sell many different closets.---
Hon äter inte frukt, inte ens äpplen.	She does not eat fruit, not even apples.---
Han är hennes sekreterare.	He is her secretary.---
Vi äter inte gammalt bröd.	We are not eating old bread.---
Antalet soldater är stort.	The number of soldiers is large.---
På sommaren är dagarna långa.	In the summer, the days are long.---
Allén är vackert gul på hösten.	The alley is beautifully yellow in the fall.---
Kvinnan vet var boken är.	The woman knows where the book is.---
Enligt honom är skärpet grönt.	According to him, the belt is green.---
Vad är dagens datum?	What is today's date?---
Jag ritar ett äpple.	Il am drawing an apple.---
Finns det internationella pass?	Are there international passports?---
Jag har många kusiner.	I have many cousins.---
Enligt honom är skärpet grönt.	According to him, the belt is green.---
Klockan är halv tre.	It is half past two.---
Ett barn, flera barn	A child, several children---
Pojkarna läser breven.	The boys are reading the letters.---
Inte förrän i morgon.	Not until tomorrow.---
Varför arbetar du som författare?	Why do you work as a writer?---
Det är den femte juli nu.	It is the fifth of July now.---
Den här boken är min.	This book is mine.---
Minuter och sekunder	Minutes and seconds---
Hunden tycker om dig därför att du	har mat.	The dog likes you because you have food.---
Flickan frågar och kvinnan svarar.	The girl is asking and the woman is	answering.---
Älgar är i allmänhet vegetarianer.	Moose are generally vegetarians.---
Mina systrars barn	My sisters' children---
Min man är finlandssvensk.	My husband is a Finland-Swede.---
Jag ser inga soldater i dag.	I don't see any soldiers today.---
Flera perioder	Several periods---
Tidningen kommer på måndagar och	onsdagar.	The newspaper comes on Mondays and	Wednesdays.---
Lagar du mat?	Are you cooking?---
Hon lyssnar aldrig på radio.	She never listens to the radio.---
Han skriver fortfarande brev till mig.	He still writes letters to me.---
Vet du var vargen är?	Do you know where the wolf is?---
Pappas katt ser sig själv i spegeln.	Dad's cat sees itself in the mirror.---
Vid vilken tid?	At what time?---
Jag läser boken på en kvart.	I am reading the book in fifteen minutes.---
Sommar och vår är årstider.	Summer and spring are seasons.---
Torsdag är en dag i veckan.	Thursday is a day of the week.---
Kommer juni före maj?	Does June come before May?---
Han skriver att han älskar henne.	He is writing that he loves her.---
Har vi tillräckligt med socker?	Do we have enough sugar?---
Letar du efter någonting?	Are you looking for something?---
Finns det ingen sked?	Isn't there any spoon?---
En tjej och en kille sjunger	tillsammans.	A girl and a guy are singing together.---
Frukten ligger på tallriken.	The fruit is on the plate.---
Vad har du i fickorna?	What do you have in your pockets?---
De visar sina skor.	They are showing their shoes.---
Han ritar en gul stol.	He is drawing a yellow chair.---
Jag vill ha ett sådant paraply.	I want an umbrella like that.---
Vart springer hon?	Where is she running?---
Det är ett svart pulver.	It is a black powder.---
Jag lyssnar därför att hon pratar.	I am listening because she is speaking.---
Är det inte torsdag i dag?	Isn't it Thursday today?---
Säljer du gafflar?	Do you sell forks?---
Han älskar mig eftersom jag älskar	honom.	He loves me because I love him.---
Skåpet är öppet.	The cabinet is open.---
Kvinnan får en häst av sin man.	The woman is getting a horse from her	husband.---
Nej, jag hinner inte.	No, I do not have enough time.---
När är festen?	When is the party?---
Jag hör dig.	I hear you.---
Pengarna ligger på bordet.	The money is on the table.---
Midsommar är i juni.	Midsummer is in June.---
Det är mitt skärp.	It is my belt.---
Den är i det andra skåpet.	It is in the other cabinet.---
Han bor antingen i Sverige eller i	Finland.	He lives either in Sweden or in Finland.---
Vem är din farbror?	Who is your uncle?---
De gör det själva.	They are doing it themselves.---
Flickan som äter ett äpple tycker om	hästar.	The girl who is eating an apple likes	horses.---
Många århundraden	Many centuries---
I västra hörnet	In the western corner---
Var har ni kastruller?	Where do you keep saucepans?---
I morgon är det helg.	Tomorrow it is the weekend.---
Min mamma är dubbelt så gammal	som jag.	My mom is twice as old as me.---
Kvinnan sover hos mannen.	The woman is sleeping at the man's place.---
Tiden med barnen är värdefull.	The time with the children is valuable.---
När är du född?	When were you born?---
Hon kramar mig.	She is hugging me.---
Hon passerar.	She is passing by.---
Vi sitter på marken.	We are sitting on the ground.---
Hon tycker om tröjan.	She likes the sweater.---
Mannen står bredvid kvinnan.	The man is standing next to the woman.---
Skådespelerskorna äter på	restaurangen.	The actresses are eating at the restaurant.---
Maten är för salt.	The food is too salty.---
Vem börjar?	Who is starting?---
Vad är en vardag?	What is a workday?---
Jag möter henne ofta på bron.	I often meet her on the bridge.---
Ett område i norr	An area in the north---
De kör runt i staden.	They are driving around town.---
Brevet är till vänster om tidningen.	The letter is to the left of the newspaper.---
Den står på min hylla.	It is on my shelf.---
Vad skrattar du åt?	What are you laughing at?---
Jag önskar mig en hund.	I am wishing for a dog.---
Februari är en av årets månader.	February is one of the months of the year.---
Vad säger du?	What are you saying?---
Vad gör denna kvinna?	What is this woman doing?---
Vi har tre stycken.	We have three of them.---
Han tycker om hennes hundar.	He likes her dogs.---
Vi är trötta!	We are tired!---
Många århundraden	Many centuries---
En viktig marknad	An important market---
Man behöver alltid vatten.	One always needs water.---
Böckerna ligger i min väns gröna	resväska.	The books are in my friend's green	suitcase.---
Ingendera av bröderna lyssnar på	mig.	Neither of the brothers is listening to me.---
Har du en sax?	Do you have a pair of scissors?---
Hon läser hans brev.	She is reading his letter.---
Pratar vi om samma sak?	Are we talking about the same thing?---
Det är min strumpa.	It is my sock.---
Min bror är modell.	My brother is a model.---
Jag tittar på tv.	I am watching TV.---
Ett litet barn	A small child---
Mitt förhållande till min bror är inte	så bra.	My relationship with my brother is not so	good.---
De gula äpplena är våra.	The yellow apples are ours.---
Det är ett värdefullt föremål.	It is a valuable object.---
Jag äter äpplet.	I am eating the apple.---
Hennes bröder är långa.	Her brothers are tall.---
Vi äter pasta i kväll.	We are eating pasta tonight.---
Kjolen	The skirt---
De lär honom engelska.	They are teaching him English.---
I september sjunger jag mycket.	In September I sing a lot.---
Jag undrar var hon är.	I wonder where she is.---
Era katter dricker vatten.	Your cats are drinking water.---
Han lägger duken på bordet.	He is laying the tablecloth on the table.---
Han sjunger varje dag.	He sings every day.---
En ren ren	A clean reindeer---
Det här är kommittén.	This is the committee.---
Den långe mannen är min chef.	The tall man is my boss.---
Flickan har en jacka.	The girl has a jacket.---
Jag talar om din generation.	I am talking about your generation.---
Hunden står bredvid hästen.	The dog is standing next to the horse.---
Vi åker hem till byn.	We are going home to the village.---
Nötköttet	The beef---
Är det din egen hund?	Is it your own dog?---
Jag är vegetarian.	I am a vegetarian.---
Jag simmar inte förrän på tisdag.	Il am not swimming until Tuesday.---
Min karriär som artist	My career as an artist---
Jag kommer om en stund.	I am coming in a while.---
Mitt badrum är dåligt.	My bathroom is bad.---
Han har fel.	He is wrong.---
Vilar han?	Is he resting?---
Arkitekten skriver ett brev.	The architect is writing a letter.---
Rocken har flera fickor.	The coat has several pockets.---
Betalar du?	Are you paying?---
Jag ligger vid poolen hela dagen.	I lie by the pool the whole day.---
Män tycker om kläder.	Men like clothes.---
Vad är det för fel på dig?	What is wrong with you?---
Ja, jag stannar.	Yes, I am staying.---
Har du det bekvämt?	Are you comfortable?---
Nätterna är våra.	The nights are ours.---
Har ni snören?	Do you have strings?---
Jag har ingen kudde.	I don't have a pillow.---
Vems är den där boken?	Whose is that book?---
Hennes moster är tolk.	Her aunt is an interpreter.---
Kvinnorna har breven.	The women have the letters.---
Maten verkar god!	The food seems tasty!---
Vi stöttar dig.	We support you.---
Tills du hittar den.	Until you find it.---
Jag skriver århundradets bok.	I am writing the book of the century.---
Ser du smörgåsarna?	Do you see the sandwiches?---
Väggarna är gröna.	The walls are green.---
Tredje generationen	The third generation---
Det regnar.	It is raining.---
Jag skriver århundradets bok.	I am writing the book of the century.---
Han har bara en handduk på sig.	He is only wearing a towel.---
Hans syster sitter i fängelse.	His sister is in prison.---
Kommer du i eftermiddag?	Are you coming this afternoon?---
En viktig fråga.	An important question.---
Var är köket?	Where is the kitchen?---
De lyssnar inte.	They are not listening.---
Vems hund är det?	Whose dog is it?---
Vakterna kommer!	The guards are coming!Skådespelarna ser oss inte.	The actors do not see us.---
Hon kommer på besök.	She is coming for a visit.---
Jag tycker om hennes katt.	I like her cat.---
Vem vet?	Who knows?---
Finns det ingen sked?	Isn't there any spoon?---
Jag står bakom dig.	I am standing behind you.---
Hennes syster är lång.	Her sister is tall.---
Vad håller du på med?	What are you doing?---
Kvinnan vet var boken är.	The woman knows where the book is.---
Nittonhundratalet	The twentieth century---
Han har en tröja.	He has a sweater.---
Jo, det gör jag.	Yes, I do.---
Det är han som läser min bok.	He is the one who is reading my book.---
Varför gör du det?	Why are you doing it?---
Har du de gamla smutsiga	strumporna?	Do you have the old dirty socks?---
Mannen lagar mat.	The man is cooking.---
Har du tid?	Do you have time?---
The movie theater---
Jag äter om du dricker.	I eat if you drink.---
Hon är hos mig.	She is at my place.---
Du äter min hunds mat.	You are eating my dog's food.---
Mannen har flera skärp.	The man has several belts.---
Det tar ett årtionde.	It takes a decade.---
Jag åker tunnelbana till jobbet.	I go by subway to work.---
Vad är du rädd för?	What are you afraid of?---
Fjärde veckan i maj	The fourth week in May---
Vilket datum är det i dag?	What date is it today?---
Ett vitt vin	A white wine---
Hon skrattar.	She is laughing.---
Jag har många fastrar.	I have many aunts.---
Summan	The sum---
Den lila klänningen är min.	The purple dress is mine.---
Han dricker ändå aldrig kaffe.	He never drinks coffee anyway.---
Jag går framåt.	I am walking forward.---
Hon läser hans brev.	She is reading his letter.---
En period	A period---
Har du ingen katt?	Don't you have a cat?---
Jag älskar inte dig, utan honom.	I do not love you, but him.---
Är lamporna nya?	Are the lamps new?---
Kockar har knivar.	Cooks have knives.---
Jag ligger vid poolen hela dagen.	I lie by the pool the whole day.---
De gula tallrikarna	The yellow plates---
Mannen använder sin tallrik.	The man is using his plate.---
I årtionden	For decades---
Det tar ungefär en timme.	It takes approximately one hour.---
Varför svarar du inte?	Why aren't you answering?---
Jag missar aldrig bussen!	I never miss the bus!---
Hjulen är vita.	The wheels are white.---
De åker.	They are going.---
Vi tittar på kaffet.	We are looking at the coffee.---
Förra veckan eller förrförra veckan?	Last week or the week before last week?---
Vi simmar i sjön.	We are swimming in the lake.---
Är din mamma på jobbet?	Is your mom at work?---
Jag har hundratals böcker!	I have hundreds of books!---
Hon har inga egna barn.	She has no children of her own.---
Här finns det mycket mat.	Here there is a lot of food.---
Har vi tillräckligt med socker?	Do we have enough sugar?---
Vi bor här.	We live here.---
Många århundraden	Many centuries---
De tar båten till Amerika.	They are taking the boat to America.---
Varför svänger du inte?	Why aren't you turning?---
Vi åker om en timme.	We are going in an hour.---
Soldaten vet vilka de är.	The soldier knows who they are.---
De använder sina strumpor.	They are using their socks.---
Vi går på restaurang.	We are going to a restaurant.---
Förstår du?	Do you understand?---
De gråter.	They are crying.---
Jag skriver århundradets bok.	I am writing the book of the century.---
Har du inga frågor?	Don't you have any questions?---
Röda tak	Red roofs---
Vems är den där boken?	Whose is that book?---
Jag tror dig!	I believe you!---
Varför ligger du på marken?	Why are you lying on the ground?---
Vad gör han för närvarande?	What is he doing currently?---
Vi tar nästa plan till Finland.	We are taking the next plane to Finland.---
Väskan har hjul.	The bag has wheels.---
Inte förrän i morgon.	Not until tomorrow.---
Dessa människor behöver mat och	vatten.	These people need food and water.---
De fortsätter.	They are continuing.---
Känner ni varandra?	Do you know each other?---
Kvinnan har på sig en kostym.	The woman is wearing a suit.---
Handduken torkar inte!	The towel is not drying!---
Lakanet är vitt.	The sheet is white.---
Kvinnan har på sig en klänning.	The woman is wearing a dress.---
Ligger hotellet vid flygplatsen?	Is the hotel by the airport?---
Norden	The Nordic countries---
Hon älskar mig inte.	She does not love me.---
Min mamma är polis.	My mom is a police officer.---
Hon talar till och med svenska.	She even speaks Swedish.---
Vi åker framåt.	We are going forward.---
Vi saknar dig.	We miss you.---
Mitt svar är ja.	My answer is yes.---
om ett halvår	in half a year---
Duken ligger på bordet.	The tablecloth is on the table.---
Har hon inga skor på sig?	Isn't she wearing any shoes?---
Ja, det gör vi alltid.	Yes, we always do that.---
Jag läser mina böcker.	I am reading my books.---
Vi ser sällan sådana stränder.	We rarely see beaches like that.---
Hon vill ha kläderna.	She wants the clothes.---
Jag har bara fyra stycken.	I only have four of them.---
Han sjunger inte särskilt bra.	He does not sing very well.---
De är rädda för vargar.	They are afraid of wolves.---
Era katter dricker vatten.	Your cats are drinking water.---
De älskar era barn.	They love your children.---
När är bröllopet?	When is the wedding?---
Du väljer hunden.	You choose the dog.---
Flickan som äter ett äpple tycker om	hästar.	The girl who is eating an apple likes	horses.---
I morgon är det helg.	Tomorrow it is the weekend.---
Ett glas vatten	A glass of water---
Om tjugofem år är jag femtio år	gammal.	In twenty-five years I will be fifty years old.---
Det tar en vecka.	It takes a week.---
Varför skrattar du åt mig?	Why are you laughing at me?---
Han är egentligen inte min bror.	He is not actually my brother.---
Jag simmar längs stranden.	Il am swimming along the beach.---
Jag litar på dig!	I trust you!---
Djur arbetar inte.	Animals do not work.---
Jag tappar min mobil.	I lose my cell phone.---
Vilka strumpor är hennes?	Which socks are hers?---
Jag älskar kläderna.	I love the clothes.---
Arbetarna litar inte på chefen.	The workers do not trust the boss.---
Han går inte utan springer.	He is not walking but running.---
Vita älgar är ovanliga.	White moose are unusual.---
Vi simmar på somrarna.	We swim in the summer.---
För ögonblicket arbetar jag.	At the moment I am working.---
Finns det ingen mat?	Isn't there any food?---
Vid vilken tid?	At what time?---
De gör det själva.	They are doing it themselves.---
Förra veckan	Last week---
Han ser fortfarande inte gammal ut.	He still does not look old.---
Hennes dotter klipper i papperet.	Her daughter is cutting the paper.---
Staden ligger på en ö.	The city is located on an island.---
Har du inget svar?	Don't you have an answer?---
Pojken är rädd för garderoben.	The boy is afraid of the closet.---
Finns det inget annat snöre?	Is there no other string?---
De gamla leksakerna är vackra.	The old toys are beautiful.---
Vi hinner inte!	We do not have enough time!---
Barnen ritar på marken.	The children are drawing on the ground.---
Hennes föräldrar har en restaurang.	Her parents have a restaurant.---
Jag talar om din generation.	I am talking about your generation.---
Han har bara en handduk på sig.	He is only wearing a towel.---
Nu börjar äventyret!	Now the adventure starts!---
Jag går på vägen med min hund.	I am walking on the road with my dog.---
Vart går du?	Where are you going?---
Barnen äter glass.	The children are eating ice cream.---
Känner du hans förra pojkvän?	Do you know his last boyfriend?---
Hon har en dålig dag.	She is having a bad day.---
Vad är hennes ålder?	What is her age?---
Femte hjulet	The fifth wheel---
Ett dygn?	A day?---
Jag går till läkaren på torsdagar.	I go to the doctor on Thursdays.---
När jag lagar mat äter hon.	When I cook, she eats.---
Pojken har ett gult äpple.	The boy has a yellow apple.---
Vad får jag för det?	What do I get for it?---
Ingen vet.	Nobody knows.---
En liten hamn	A small port---
Välkommen till mitt land!	Welcome to my country!---
Älgen äter ett äpple till.	The moose is eating one more apple.---
Fönstret är öppet.	The window is open.---
ingendera av dem	neither of them---
Han är präst.	Heiis a priest.---
De lever i arton år.	They live for eighteen years.---
Hon leker.	She is playing.---
Kallt kaffe	Cold coffee---
De pratar om sina resor till Sverige.	They are talking about their trips to	Sweden.---
Ett århundrade	A century---
Björnen hittar mat.	The bear finds food.---
Han är på semester i Finland.	He is on vacation in Finland.---
Skjortan har knappar.	The shirt has buttons.---
De andra kvinnorna	The other women---
Jag bygger hus.	I build houses.---
Det är kväll.	It is evening.---
Vin är en dryck.	Wine is a beverage.---
Nätterna är våra.	The nights are ours.---
På lördagar tittar jag alltid på tv.	On Saturdays I always watch TV.---
Vilken dag är det?	What day is it?---
Det finns bröd.	There is bread.---
Vi har svaren.	We have the answers.---
Hur mår du?	How are you?---
Min morbror är min mors bror.	My uncle is my mother's brother.---
Du är inte gammal.	You are not old.---
Tallriken är mellan dig och mig.	The plate is between you and me.---
Vargen äter den svarta ankan.	The wolf is eating the black duck.---
Kvinnorna har på sig klänningar.	The women are wearing dresses.---
Vi arbetar fyrtio timmar per vecka.	We work forty hours per week.---
Systrarna sjunger.	The sisters are singing.---
Hon sitter framför mig.	Sheiis sitting in front of me.---
Årstiderna är vår, sommar, höst och	vinter.	The seasons are spring, summer, fall and	winter.---
Hon kommer när som helst.	She is coming at any time.---
Ett halvår	Half a year---
Vilka smörgåsar är våra?	Which sandwiches are ours?---
Flickorna läser breven.	The girls are reading the letters.---
Ett ögonblick!	One moment!---
Räcker det?	Is it enough?---
Har du det bekvämt?	Are you comfortable?---
Det är en allvarlig fråga.	It is a serious question.---
Mängden olja är viktig.	The amount of oil is important.---
Skjortan torkar.	The shirt is drying.---
Min syster är brandman.	My sister is a firefighter.---
Vad har du i fickorna?	What do you have in your pockets?---
Vilken karriär!	What a career!---
Flickan visar sin bok.	The girl is showing her book.---
Hur är det möjligt?	How is it possible?---
Tycker du om ditt yrke?	Do you like your profession?---
De bygger båten.	They are building the boat.---
Jag vill ha dubbelt så mycket.	I want twice as much.---
Jag väljer åt dig.	I am choosing for you.---
Riset	The rice---
Det regnar mycket i november.	It rains a lot in November.---
Jag är född på sommaren.	I was born in the summer.---
Vem har flera sekreterare?	Who has several secretaries?---
Ser du mig?	Do you see me?---
Landet har långa kuster.	The country has long coasts.---
Min familj bor söder om staden.	My family lives south of the city.---
Vi läser en stund.	We are reading for a while.---
Vi arbetar inte på lördagar.	We do not work on Saturdays.---
Har du några barn?	Do you have any children?---
Mitt ägg är blått.	My egg is blue.---
Skorna är mina.	The shoes are mine.---
Vi hyr cyklar.	We are renting bicycles.---
Min svärfar är min frus far och min	far är hennes svärfar.	My father-in-law is my wife's father, and	my father is her father-in-law.---
Ett stort hjul	A big wheel---
Han bor antingen i Sverige eller i	Finland.	He lives either in Sweden or in Finland.---
Hur tvättar ni de andra mattorna?	How do you wash the other carpets?---
Pratar vi om samma sak?	Are we talking about the same thing?---
Sjunger han på tisdagar?	Does he sing on Tuesdays?---
Vem som helst	Anyone---
Är det inte torsdag i dag?	Isn't it Thursday today?---
Vart simmar ankan?	Where is the duck swimming?---
Vi äter om en stund.	We are eating in a while.---
Vad gör denna kvinna?	What is this woman doing?---
Dörren är inte ens öppen.	The door is not even open.---
Barnen är tvåspråkiga.	The children are bilingual.---
Vem svarar på en sådan fråga?	Who answers a question like that?---
Kostymerna är dyra.	The suits are expensive.---
En värdefull bok	A valuable book---
Hon har skor på sig.	She is wearing shoes.---
Varför tycker du så mycket om juni?	Why do you like June so much?---
I september sjunger jag mycket.	In September I sing a lot.---
Ett barn, flera barn	A child, several children---
Han tycker om hennes hundar.	He likes her dogs.---
Hon är årtiondets kvinna.	She is the woman of the decade.---
Vi går genom restaurangen.	We are walking through the restaurant.---
Hennes klänning är verkligen	vacker.	Her dress is really beautiful.---
Spädbarnet är en dag gammalt.	The baby is a day old.---
Det är antingen en matta eller en	handduk.	It is either a rug or a towel.---
Vårt äpple	Our apple---
Vem svarar?	Who is answering?---
Vargen vet att björnen sover.	The wolf knows that the bear is sleeping.---
De sover.	They are sleeping.---
Pojken frågar flickan.	The boy is asking the girl.---
De kommer om en kvart.	They are coming in fifteen minutes.---
Det finns flera finlandssvenska	städer i Finland.	There are several Finno-Swedish cities in	Finland.---
De rosa byxorna är hennes.	The pink pants are hers.---
Juli är en månad på året.	July is a month of the year.---
Våra barns böcker	Our children's books---
Det är en vanlig fråga.	It is a normal question.---
Andra veckan i maj	The second week in May---
Jag dricker svart kaffe.	I am drinking black coffee.---
På midsommar äter vi mycket mat.	On Midsummer we eat a lot of food.---
Det tar bara en minut.	It only takes a minute.---
De kommer i helgen.	They are coming this weekend.---
Min farfar är advokat.	My grandfather is a lawyer.---
Han lagar mat medan vi sover.	He cooks while we sleep.---
Vad gör du den sjätte juni?	What are you doing the sixth of June?---
Våra pappor är bröder.	Our dads are brothers.---
Har du en knapp?	Do you have a button?---
Ser de oss?	Do they see us?---
Det finns många sjöar i Sverige.	There are many lakes in Sweden.---
Barnen läser breven.	The children are reading the letters.---
Skådespelerskan köper ett palats	med många torn.	The actress is buying a palace with many	towers.---
Det är en väldigt dyr maskin.	It is a very expensive machine.---
Slipsen är hans.	The tie is his.---
Nu är det för sent!	Now it is too late!---
Enligt henne är hästen vit.	According to her, the horse is white.---
Han talar inte heller engelska.	He does not speak English either.---
Vad gör din hund?	What is your dog doing?---
Hon har sin fina klänning på sig.	She is wearing her nice dress.---
Vem liknar barnet?	Who does the child resemble?---
Det är nionde gången jag är här.	It is the ninth time I am here.---
Ett stort antal människor.	A large number of people.---
Palatset ligger utanför huvudstaden.	The palace is located outside the capital.---
Åker du dit i kväll?	Are you going there tonight?---
En förälder är ett barns mamma	eller pappa.	A parent is a child's mom or dad.---
I sista sekunden	At the last second---
De kommer på torsdag.	They are coming on Thursday.---
Flickan ritar en älg.	The girl is drawing a moose.---
Jag sover i flera timmar.	I am sleeping for several hours.---
Barnet läser en bok.	The child is reading a book.---
Hotellet ligger vid kusten.	The hotel is located by the coast.---
Min faster är min pappas syster.	My aunt is my dad's sister.---
Till och med jag tycker om henne.	Even I like her.---
Han tycker om er.	He likes you.---
Jag är på semester!	I am on vacation!---
Den sjunde boken är den sista.	The seventh book is the last.---
Jag sitter bakom dig.	I am sitting behind you.---
Han har en vit tröja på sig.	He is wearing a white sweater.---
Nätterna är svarta.	The nights are black.---
Maten räcker inte.	There is not enough food.---
Han fortsätter sitt arbete.	He is continuing his work.---
Är hennes föräldrar författare?	Are her parents writers?---
Det är inte nödvändigtvis en dyr	kostym.	It is not necessarily an expensive suit.---
Hon har på sig strumpor.	She is wearing socks.---
Vi åker till Sverige på semester.	We are going to Sweden on vacation.---
Hur många arbetare har ni?	How many workers do you have?---
Det verkar som att kostymen är	orange.	It seems like the suit is orange.---
Älgar är i allmänhet vegetarianer.	Moose are generally vegetarians.---
Det här är kommittén.	This is the committee.---
Stannar du på en kopp te?	Are you staying for a cup of tea?---
Du känner mig!	You know me!---
Brödet innehåller salt.	The bread contains salt.---
En skjorta, flera skjortor	A shirt, several shirts---
Hon fyller poolen med vatten.	She is filling the pool with water.---
Hon arbetar på en annan avdelning.	She works in another department.---
Vad är det för fel på dig?	What is wrong with you?---
Jag tackar dig.	I thank you.---
Jag väntar på dig.	I am waiting for you.---
Museet är inte öppet än.	The museum is not open yet.---
Ett och ett halvt år	One and a half years---
Min moster är min mors syster.	My aunt is my mother's sister.---
Hon är chef för avdelningen.	She is the boss of the department.---
Mannen står bredvid kvinnan.	The man is standing next to the woman.---
Hon använder kläderna innan hon	säljer dem.	She uses the clothes before she sells	them.---
Jag tycker inte om de bruna äpplena.	I do not like the brown apples.---
Vi köper ett annat bord.	We are buying another table.---
Nej, vi är inte dåliga!	No, we are not bad!---
Jag älskar jackan.	I love the jacket.---
Han tar ett föremål från bordet.	He is taking an object from the table.---
De har på sig kostymerna.	They are wearing the suits.---
Hon dör.	She is dying.---
Jag litar egentligen inte på honom.	I do not actually trust him.---
Om ett ögonblick!	In a moment!---
Jag älskar min moster.	I love my aunt.---
Ert barn läser en tidning.	Your child is reading a newspaper.---
Varför ringer hon mig inte?	Why does she not call me?---
Barnens hundar	The children's dogs---
Vad är dagens datum?	What is today's date?---
Han köper något till barnen.	He is buying something for the children.---
Fryser ni inte?	Aren't you freezing?---
Batteriet är för gammalt.	The battery is too old.---
Vad tillverkar de?	What do they produce?---
Hans kostym kommer om en månad.	His suit is coming in a month.---
Hon är nitton och arbetar med sin	mamma.	She is nineteen and works with her mom.---
Vad skrattar du åt?	What are you laughing at?---
Han följer efter mig.	He is following me.---
Det regnar inte mycket i juli.	It does not rain a lot in July.---
Han kysser mig.	He is kissing me.---
Han får ett svar.	He is getting an answer.---
Alla utom kocken äter.	Everyone except the cook is eating.---
Vem väntar ni på?	Who are you waiting for?---
Nu är klockan halv fem.	Now, it is half past four.---
Har ni en bastu?	Do you have a sauna?---
Han har skjortor i olika färger.	He has shirts in different colors.---
Ett antal år	A number of years---
Jag hinner inte i dag.	I do not have enough time today.---
Jag vet inte om han vill.	I do not know if he wants to.---
Ett dygn	A day---
Kastrullerna står på bordet.	The saucepans are on the table.---
Hon hör mig inte.	She does not hear me.---
Jag kommer på besök.	I am coming for a visit.---
Toaletterna är där borta.	The toilets are over there.---
Han lyssnar.	Heiis listening.---
Skon är din.	The shoe is yours.---
Din pappa ser ut som en turist.	Your dad looks like a tourist.---
Vilken skjorta är blå?	Which shirt is blue?---
Svaret är nej.	The answer is no.---
Den svarta spindeln	The black spider---
Vad önskar du dig?	What are you wishing for?---
Vi äter mycket mat i december.	We eat a lot of food in December.---
Vårt hotell ligger vid stranden.	Our hotel is by the beach.---
Hon äter inte frukt, inte ens äpplen.	She does not eat fruit, not even apples.---
Det är mitt skärp.	It is my belt.---
År och månader	Years and months---
Björnen är ett stort djur.	The bear is a big animal.---
Det regnar och barnen springer.	It is raining and the children are running.---
De blandar vin med vatten.	They are mixing wine with water.---
Han känner henne.	He knows her.---
Vi visar en turist vägen till hotellet.	We are showing a tourist the way to the	hotel.---
Djuren dricker vatten.	The animals are drinking water.---
Männen läser böckerna.	The men are reading the books.---
Kniven är vid glaset.	The knife is by the glass.---
Du vet att jag älskar dig.	You know that I love you.---
Vad letar ni efter?	What are you looking for?---
Var har ni kastruller?	Where do you keep saucepans?---
Min pappa är en stor man.	My father is a big man.---
Hon tvättar sig med tvål och vatten.	She is washing herself with soap and	water.---
Vi bor i dalen.	We live in the valley.---
Finns det inga toaletter här?	Aren't there any toilets here?---
Jag orkar inte!	I do not have the energy!---
Fem stycken, tack!	Five of them, please!---
Hallå, är det någon där?	Hello, is there someone there?---
Hans hund äter fisk.	His dog is eating fish.---
Till och med farfar sjunger.	Even grandfather is singing.---
Min moster har många döttrar.	My aunt has many daughters.---
Hur många böcker läser hon?	How many books is she reading?---
Vilken vill du ha? Ingendera.	Which do you want? Neither.---
Boken är konstig.	The book is strange.---
Jag älskar mitt yrke.	I love my profession.---
De har öppet på söndagar.	They are open on Sundays.---
Jag äter hos honom.	I am eating at his place.---
Mannen och kvinnan pratar.	The man and the woman are speaking.---
Han har de gula byxorna.	He has the yellow pants.---
Jag är domare.	Il am a judge.---
Jag gråter inte.	I am not crying.---
Jag tycker om dig, men jag älskar	henne.	I like you, but I love her.---
Är det lördag eller söndag i dag?	Is it Saturday or Sunday today?---
Jag vill också ha ett äpple.	I also want an apple.---
Ett djur, flera djur	An animal, several animals---
Äntligen ser du mig!	Finally you see me!---
Om en dag	In a day---
Jag vill ha en smörgås.	I want a sandwich.---
Mina föräldrar är gamla.	My parents are old.---
Du har på dig min tröja.	You are wearing my sweater.---
Juni är årets sjätte månad.	June is the sixth month of the year.---
Kaffet är inte varmt.	The coffee is not warm.---
De äter på nätterna.	They eat at night.---
Min pappas bror är min farbror.	My dad's brother is my uncle.---
Den nionde april	The ninth of April---
Vad innehåller boken?	What does the book contain?---
De reser runt i landet.	They are traveling around the country.---
Det här är min fru.	This is my wife.---
På fredag kommer brevet.	On Friday the letter is coming.---
Antalet soldater är stort.	The number of soldiers is large.---
Det står en korg på bordet.	There is a basket on the table.---
Pojken har en skjorta.	The boy has a shirt.---
Mannen har brevet.	The man has the letter.---
Han skriver att han älskar henne.	He is writing that he loves her.---
Det är den sista dagen.	It is the last day.---
Han är på arbetet.	He is at work.---
Personalen på restaurangen	The staff at the restaurant---
Vem som helst som arbetar med	barn vet vad jag pratar om.	Anyone who works with children knows	what I am talking about.---
Motorn är effektiv.	The engine is efficient.---
Brevet är till vänster om tidningen.	The letter is to the left of the newspaper.---
De första gångerna	The first times---
En liten kaffe, tack!	One small coffee, please!---
Över barnen flyger fåglarna.	Over the children, the birds are flying.---
Det är den femte juli nu.	It is the fifth of July now.---
Behöver du någonting?	Do you need anything?---
De betalar tio miljoner för hotellet.	They are paying ten million for the hotel.---
Den sjunde dagen	The seventh day---
Ett rött skåp	A red cabinet---
Barn bor i allmänhet hos sina	föräldrar.	Children generally live with their parents.---
Vi äter innan vi går.	We eat before we walk.---
Vakten	The guard---
Jag arbetar sammanlagt tre veckor.	I work a total of three weeks.---
Våra egna handskar	Our own gloves---
Allén är vackert gul på hösten.	The alley is beautifully yellow in the fall.---
Min bror kommer sist.	My brother is coming last.---
Det är måndag i dag.	It is Monday today.---
Farmor läser tidningen.	Grandmother is reading the newspaper.---
Vattnet i kastrullen är varmt.	The water in the saucepan is warm.---
Hur kommer man till stranden?	How does one get to the beach?---
Ja, det finns kaffe.	Yes, there is coffee.---
Min mormor har många klockor.	My grandmother has a lot of clocks.---
De rosa byxorna är hans.	The pink pants are his.---
Långt bort	Far away---
Ni är välkomna till oss i oktober.	You are welcome to our place in October.---
Finns det inget kaffe?!	Is there no coffee?!---
Varför ligger sakerna på golvet?	Why are the things lying on the floor?---
Mannen skriver datumet på brevet.	The man is writing the date on the letter.---
En arbetare kommer.	A worker is coming.---
Det är ett smutsigt jobb.	It is a dirty job.---
De är på stranden.	They are at the beach.---
Vi känner inte varandra.	We do not know each other.---
Vi behöver mer tyg.	We need more cloth.---
Han bor i en annan stad.	He lives in another city.---
Artistens vakter springer efter	kvinnan.	The artist's guards are running after the	woman.---
Älgen tittar på pojken.	The moose is looking at the boy.---
En av hundarna springer.	One of the dogs is running.---
Jag simmar inte förrän på tisdag.	Il am not swimming until Tuesday.---
Jag skriver brev på morgonen.	I write letters in the morning.---
Stämmer det?	Is that correct?---
Restaurangerna är öppna.	The restaurants are open.---
Jag läser tidningen sent på kvällen.	I read the newspaper late in the evening.---
Enligt honom är skärpet grönt.	According to him, the belt is green.---
Katten äter fisken.	The cat is eating the fish.---
Min morfar har tio barnbarn.	My grandfather has ten grandchildren.---
Du har en ny klänning.	You have a new dress.---
Hon äter frukost på morgonen.	She eats breakfast in the morning.---
Min mamma är dubbelt så gammal	som jag.	My mom is twice as old as me.---
Vad heter din tvilling?	What is your twin's name?---
Kvinnan älskar sina barn.	The woman loves her children.---
Jag möter dig på hotellet.	I am meeting you at the hotel.---
Barnen leker i en kvart.	The children play for fifteen minutes.---
Jag lagar mat.	I am cooking.---
En biljett, tack!	A ticket, please!---
Jag tycker om de gula fåglarna.	I like the yellow birds.---
Tusentals människor läser hennes	böcker.	Thousands of people read her books.---
Det är precis samma färg.	It is exactly the same color.---
Djuren	The animals---
Hon har sina vanliga kläder på sig.	She is wearing her normal clothes.---
Vi bjuder henne på lunch.	We are treating her to lunch.---
Har de inga tallrikar?	Don't they have any plates?---
Vi frågar sammanlagt hundra	personer.	We are asking a total of a hundred people.---
På eftermiddagen	In the afternoon---
Jag undrar varför.	I wonder why.---
Det tar generationer.	It takes generations.---
Kvinnan tycker om skärpet.	The woman likes the belt.---
Varför lär du honom svenska?	Why are you teaching him Swedish?---
Jag vill ha en halsduk.	I want a scarf.---
Jag ställer flaskan i skåpet.	I am putting the bottle in the cabinet.---
Byggnaden är tom.	The building is empty.---
Det kostar för mycket!	It costs too much!---
Torsdag kommer före fredag.	Thursday comes before Friday.---
Han tror mig inte.	He does not believe me.---
Vilken historisk period läser du om?	What historical period are you reading	about?---
Ett långt brev.	A long letter.---
Pojken springer och sjunger.	The boy is running and singing.---
Pengarna ligger på bordet.	The money is on the table.---
De använder en professionell	modell.	They are using a professional model.---
Det är inte nödvändigtvis hans	mamma.	It is not necessarily his mother.---
Kvinnan har tidningen.	The woman has the newspaper.---
Barnen har många leksaker.	The children have many toys.---
De säljer många olika garderober.	They sell many different closets.---
Han är hennes sekreterare.	He is her secretary.---
Vi äter inte gammalt bröd.	We are not eating old bread.---
På sommaren är dagarna långa.	In the summer, the days are long.---
Jag ritar ett äpple.	Il am drawing an apple.---
Finns det internationella pass?	Are there international passports?---
Jag har många kusiner.	I have many cousins.---
Klockan är halv tre.	It is half past two.---
Pojkarna läser breven.	The boys are reading the letters.---
Varför arbetar du som författare?	Why do you work as a writer?---
Den här boken är min.	This book is mine.---
Minuter och sekunder	Minutes and seconds---
Hunden tycker om dig därför att du	har mat.	The dog likes you because you have food.---
Flickan frågar och kvinnan svarar.	The girl is asking and the woman is	answering.---
Mina systrars barn	My sisters' children---
Min man är finlandssvensk.	My husband is a Finland-Swede.---
Jag ser inga soldater i dag.	I don't see any soldiers today.---
Flera perioder	Several periods---
Tidningen kommer på måndagar och	onsdagar.	The newspaper comes on Mondays and	Wednesdays.---
Lagar du mat?	Are you cooking?---
Hon lyssnar aldrig på radio.	She never listens to the radio.---
Han skriver fortfarande brev till mig.	He still writes letters to me.---
Vet du var vargen är?	Do you know where the wolf is?---
Pappas katt ser sig själv i spegeln.	Dad's cat sees itself in the mirror.---
Jag läser boken på en kvart.	I am reading the book in fifteen minutes.---
Sommar och vår är årstider.	Summer and spring are seasons.---
Torsdag är en dag i veckan.	Thursday is a day of the week.---
Kommer juni före maj?	Does June come before May?---
Letar du efter någonting?	Are you looking for something?---
En tjej och en kille sjunger	tillsammans.	A girl and a guy are singing together.---
Frukten ligger på tallriken.	The fruit is on the plate.---
De visar sina skor.	They are showing their shoes.---
Han ritar en gul stol.	He is drawing a yellow chair.---
Jag vill ha ett sådant paraply.	I want an umbrella like that.---
Vart springer hon?	Where is she running?---
Det är ett svart pulver.	It is a black powder.---
Jag lyssnar därför att hon pratar.	I am listening because she is speaking.---
Säljer du gafflar?	Do you sell forks?---
Han älskar mig eftersom jag älskar	honom.	He loves me because I love him.---
Skåpet är öppet.	The cabinet is open.---
Kvinnan får en häst av sin man.	The woman is getting a horse from her	husband.---
Nej, jag hinner inte.	No, I do not have enough time.---
När är festen?	When is the party?---
Jag hör dig.	I hear you.---
Midsommar är i juni.	Midsummer is in June.---
Den är i det andra skåpet.	It is in the other cabinet.---
Vem är din farbror?	Who is your uncle?---
I västra hörnet	In the western corner---
Kvinnan sover hos mannen.	The woman is sleeping at the man's place.---
Tiden med barnen är värdefull.	The time with the children is valuable.---
När är du född?	When were you born?---
Hon kramar mig.	She is hugging me.---
Hon passerar.	She is passing by.---
Vi sitter på marken.	We are sitting on the ground.---
Hon tycker om tröjan.	She likes the sweater.---
Skådespelerskorna äter på	restaurangen.	The actresses are eating at the restaurant.---
Maten är för salt.	The food is too salty.---
Vem börjar?	Who is starting?---
Vad är en vardag?	What is a workday?---
Jag möter henne ofta på bron.	I often meet her on the bridge.---
Ett område i norr	An area in the north---
De kör runt i staden.	They are driving around town.---
Den står på min hylla.	It is on my shelf.---
Jag önskar mig en hund.	I am wishing for a dog.---
Februari är en av årets månader.	February is one of the months of the year.---
Vad säger du?	What are you saying?---
Vi har tre stycken.	We have three of them.---
Vi är trötta!	We are tired!---
En viktig marknad	An important market---
Man behöver alltid vatten.	One always needs water.---
Böckerna ligger i min väns gröna	resväska.	The books are in my friend's green	suitcase.---
Ingendera av bröderna lyssnar på	mig.	Neither of the brothers is listening to me.---
Har du en sax?	Do you have a pair of scissors?---
Det är min strumpa.	It is my sock.---
Min bror är modell.	My brother is a model.---
Jag tittar på tv.	I am watching TV.---
Ett litet barn	A small child---
Mitt förhållande till min bror är inte	så bra.	My relationship with my brother is not so	good.---
De gula äpplena är våra.	The yellow apples are ours.---
Det är ett värdefullt föremål.	It is a valuable object.---
Jag äter äpplet.	I am eating the apple.---
Hennes bröder är långa.	Her brothers are tall.---
Vi äter pasta i kväll.	We are eating pasta tonight.---
Kjolen	The skirt---
De lär honom engelska.	They are teaching him English.---
Jag undrar var hon är.	I wonder where she is.---
Han lägger duken på bordet.	He is laying the tablecloth on the table.---
Han sjunger varje dag.	He sings every day.---
En ren ren	A clean reindeer---
Den långe mannen är min chef.	The tall man is my boss.---
Flickan har en jacka.	The girl has a jacket.---
Hunden står bredvid hästen.	The dog is standing next to the horse.---
Vi åker hem till byn.	We are going home to the village.---
Nötköttet	The beef---
Är det din egen hund?	Is it your own dog?---
Jag är vegetarian.	I am a vegetarian.---
Min karriär som artist	My career as an artist---
Jag kommer om en stund.	I am coming in a while.---
Mitt badrum är dåligt.	My bathroom is bad.---
Han har fel.	He is wrong.---
Vilar han?	Is he resting?---
Arkitekten skriver ett brev.	The architect is writing a letter.---
Rocken har flera fickor.	The coat has several pockets.---
Betalar du?	Are you paying?---
Män tycker om kläder.	Men like clothes.---
Ja, jag stannar.	Yes, I am staying.---
Har ni snören?	Do you have strings?---
Jag har ingen kudde.	I don't have a pillow.---
Hennes moster är tolk.	Her aunt is an interpreter.---
Kvinnorna har breven.	The women have the letters.---
Maten verkar god!	The food seems tasty!---
Vi stöttar dig.	We support you.---
Tills du hittar den.	Until you find it.---
Ser du smörgåsarna?	Do you see the sandwiches?---
Väggarna är gröna.	The walls are green.---
Tredje generationen	The third generation---
Det regnar.	It is raining.---
Hans syster sitter i fängelse.	His sister is in prison.---
Kommer du i eftermiddag?	Are you coming this afternoon?---
En viktig fråga.	An important question.---
Var är köket?	Where is the kitchen?---
De lyssnar inte.	They are not listening.---
Vems hund är det?	Whose dog is it?---
Vakterna kommer!	The guards are coming!